human_rights_un_ita_dan_64kb_0001	l dˈiːrtʃembe lssemblea enerale rlle adzioni nite approvɔ e proklamɔ la ikjˈaːrradzione niversale ri iritti mani il kui testo kompleto ɛ stampato nelle padʒne seɡuenti
human_rights_un_ita_dan_64kb_0002	opo kuesta solenne rliberadzione lssemblea rlle adzioni nite dˈiːredˈeːr istrudzioni al edʒetario enerale di provvedˈeːre a dˈiːrffoere ampiamente kuesta ikjˈaːrradzione e a tal fine di pbblikarne e dˈiːrstribuirne il testo non soltanto nelle tʃinkue lindʒue uffjtʃali rllrɡanidzdzatsione interadzioale ma anke in kuante alte lindʒue fosse possibile usando oɲi metsdzo a sua dˈiːrsposidzione
human_rights_un_ita_dan_64kb_0003	l testo uffjtʃale rlla ikjˈaːrradzione ɛ dˈiːrsponibile nelle lindʒue uffjtʃali rlle adzioni nite tʃoɛ tʃinese frantʃese inʎese russo e spaɲolo
human_rights_un_ita_dan_64kb_0004	
human_rights_un_ita_dan_64kb_0005	eambolo
human_rights_un_ita_dan_64kb_0006	onsirrato ke il rikonoʃmento rlla dˈiːrɲita ineente a tutti i membri rlla famiʎia umana e ri loro dˈiːrritti udʒuali ed ialieabili kostituiʃɛ il fondamento rlla liberta rlla dʒustidzia e rlla patʃe nel mondo
human_rights_un_ita_dan_64kb_0007	onsirrato ke il dˈiːrʃonoʃmento e il dˈiːrspetstso ri dˈiːrritti umani ∅anno portato ad atti di barbarie ke offˈɛndedono la koʃendza rllumanita e ke lavvento di un mondo in kui ʎi esseri umani dʒodano rlla liberta di parola e di kredo e rlla liberta dal timoe e dal bisoɲo ɛ stato proklamato kome la piu alta aspiradzione rllwomo
human_rights_un_ita_dan_64kb_0008	onsirrato ke ɛ indˈiːrspensabile ke i dˈiːrritti umani siano protetti da norme dʒuridˈiːrke se si vwole evitˈaːre ke lwomo sia kostetto a rikorrˈeːre kome ultima istandza alla ribellione kontro la tirannia e loppessione
human_rights_un_ita_dan_64kb_0009	onsirrato ke ɛ indˈiːrspensabile promwovˈeːre lo sviluppo di rapporti amikevoli tra le adzioni
human_rights_un_ita_dan_64kb_0010	onsirrato ke i popoli rlle adzioni nite ∅anno riaffˈɛndrmato nello tatuto la loro fˈɛndr nei dˈiːrritti umani fondamentali nella dˈiːrɲita e nel valoe rlla persoa umana nelluɡuaʎiantsa ri dˈiːrritti rllwomo e rlla dona ed ∅anno rtʃso di promwovˈeːre il proɡesso sotʃale e un miʎior tenoe di vita in ua mauɡdʒoe liberta
human_rights_un_ita_dan_64kb_0011	onsirrato ke ʎi tati membri si sono impeuɲɲati a perseɡuˈiːre in kooperadzione kon le adzioni nite il rispetto e losservandza universale ri dˈiːrritti umani e rlle liberta fondamentali
human_rights_un_ita_dan_64kb_0012	onsirrato ke ua kontʃedzione komune di kuesti dˈiːrritti e di kuesta liberta ɛ rlla massima importandza per la piea ealitsdzadzione di kuesti impeɲi
human_rights_un_ita_dan_64kb_0013	proklamala pesente dˈiːrkjˈaːrradzione universale ri dˈiːrritti umani kome irale komune da raɡdʒundʒersi da tutti i popoli e da tutte le adzioni al fine ke oɲi indˈiːrvidwo ed oɲi orɡano rlla sotʃeta avendo kostantemente pesente kuesta ikjˈaːrradzione si sfordzi di promwovˈeːre kon linseuɲɲamento e ledukadzione il rispetto di kuesti dˈiːrritti e di kueste liberta e di dʒarantirne medˈiːrante misue prodʒessive di karattˈeːre adzioale e interadzioale luniversale ed effˈɛndttivo rikonoʃmento e rispetto tanto fra i popoli rʎi stessi tati membri kuanto fra kuelli ri territori sottoposti alla loro dʒurisdˈiːrdzione
human_rights_un_ita_dan_64kb_0014	rtikolo
human_rights_un_ita_dan_64kb_0015	utti ʎi esseri umani naʃono liberi ed euɲɲuali in dˈiːrɲita e dˈiːrritti
human_rights_un_ita_dan_64kb_0016	ssi sono dotati di radʒone e di koʃendza e rvono adʒe ʎi uni verso ʎi altri in spirito di fratellandza
human_rights_un_ita_dan_64kb_0017	rtikolo
human_rights_un_ita_dan_64kb_0018	d oɲi indˈiːrvidwo spettano tutti i dˈiːrritti e tutte le liberta enwntʃˈaːrte nella pesente ikjˈaːrradzione sendza dˈiːrstindzione alkua per radʒoni di radztsa di koloe di sesso di linuɲɲua di elidʒone di opinione politika o di altro dʒenˈeːre di oridʒne adzioale o sotʃale di rikkedztsa di aʃta o di altra kondˈiːrdzione
human_rights_un_ita_dan_64kb_0019	essua dˈiːrstindzione sara inolte stabilita sulla base rllo statuto politiko dʒuridˈiːrko o interadzioale rl paese o rl territorio kui ua persoa appartiene sia indˈiːrpˈɛndernte o sottoposto ad amministradzione fjdutʃˈaːrria o non autonomo o souɡdʒetto a kualsiasi limitadzione di sovranita
human_rights_un_ita_dan_64kb_0020	rtikolo
human_rights_un_ita_dan_64kb_0021	ɲi indˈiːrvidwo ∅a dˈiːrritto alla vita alla liberta ed alla sikuedztsa rlla propria persoa
human_rights_un_ita_dan_64kb_0022	rtikolo
human_rights_un_ita_dan_64kb_0023	essun indˈiːrvidwo potra essˈeːre tenuto in stato di skjavitu o di servitu
human_rights_un_ita_dan_64kb_0024	la skjavitu e la tratta rʎi skjavi saranno proibite sotto kualsiasi forma
human_rights_un_ita_dan_64kb_0025	rtikolo
human_rights_un_ita_dan_64kb_0026	essun indˈiːrvidwo potra essˈeːre sottoposto a tortura o a trattamento o a pnidzione krurli inwmani o rɡradanti
human_rights_un_ita_dan_64kb_0027	rtikolo
human_rights_un_ita_dan_64kb_0028	ɲi indˈiːrvidwo ∅a dˈiːrritto in oɲi lwouɲɲo al rikonoʃmento rlla sua persoalita dʒuridˈiːrka
human_rights_un_ita_dan_64kb_0029	rtikolo
human_rights_un_ita_dan_64kb_0030	utti sono euɲɲuali dinandzi alla ledʒdʒe e ∅anno dˈiːrritto sendza alkua dˈiːrʃriminˈaːrdzione ad ua euɡuale tutela da parte rlla ledʒdʒe
human_rights_un_ita_dan_64kb_0031	utti ∅anno dˈiːrritto ad ua euɡuale tutela kontro oɲi dˈiːrʃriminˈaːrdzione ke violi la pesente ikjˈaːrradzione kome kontro kualsiasi intʃtamento a tale dˈiːrʃriminˈaːrdzione
human_rights_un_ita_dan_64kb_0032	rtikolo
human_rights_un_ita_dan_64kb_0033	ɲi indˈiːrvidwo ∅a dˈiːrritto ad uneffˈɛndttiva possibilita di rikorso a kompetenti tribuali kontro atti ke violino i dˈiːrritti fondamentali a lui rikonoʃʃti dalla kostitudzione o dalla ledʒdʒe
human_rights_un_ita_dan_64kb_0034	rtikolo
human_rights_un_ita_dan_64kb_0035	essun indˈiːrvidwo potra essˈeːre arbitrariamente arestato rtenuto o esiliato
human_rights_un_ita_dan_64kb_0036	rtikolo
human_rights_un_ita_dan_64kb_0037	ɲi indˈiːrvidwo ∅a dˈiːrritto in posidzione di piea uɡuaʎiantsa ad ua ekua e pbblika udˈiːrendza davanti ad un tribuale indˈiːrpˈɛndernte e impardziale al fine rlla rterminˈaːrdzione ri suoi dˈiːrritti e ri suoi doveri nonke rlla fondatetstsa di oɲi atʃkusa peale ke ʎi venɡa rivolta
human_rights_un_ita_dan_64kb_0038	rtikolo
human_rights_un_ita_dan_64kb_0039	ɲi indˈiːrvidwo atʃkusato di un eato ɛ pesunto innokente sino a ke la sua kolpevoledztsa non sia stata provata ledʒalmente in un pbbliko prokesso nel kuale eʎi abbia avuto tutte le dʒarandzie netʃessarie per la sua dˈiːrfˈɛndsa
human_rights_un_ita_dan_64kb_0040	essun indˈiːrvidwo sara kondanato per un komportamento kommissivo od omissivo ke al momento in kui sia stato perpetuato non kostituisse eato sekondo il dˈiːrritto interno o sekondo il dˈiːrritto interadzioale
human_rights_un_ita_dan_64kb_0041	on potra rl pari essˈeːre inflitta alkua pena superioe a kuella applikabile al momento in kui il eato sia stato kommesso
human_rights_un_ita_dan_64kb_0042	rtikolo
human_rights_un_ita_dan_64kb_0043	essun indˈiːrvidwo potra essˈeːre sottoposto ad interfˈɛndendze arbitrarie nella sua vita privata nella sua famiʎia nella sua kasa nella sua korrispoerndza ne a lesione rl suo onoe e rlla sua eputadzione
human_rights_un_ita_dan_64kb_0044	ɲi indˈiːrvidwo ∅a dˈiːrritto ad essˈeːre tutelato dalla ledʒdʒe kontro tali interfˈɛndendze o lesioni
human_rights_un_ita_dan_64kb_0045	rtikolo
human_rights_un_ita_dan_64kb_0046	ɲi indˈiːrvidwo ∅a dˈiːrritto alla liberta di movimento e di esirndza entro i konfini di oɲi tato
human_rights_un_ita_dan_64kb_0047	ɲi indˈiːrvidwo ∅a dˈiːrritto di laʃˈaːre kualsiasi paese inkluso il proprio e di ritornˈaːre nel proprio paese
human_rights_un_ita_dan_64kb_0048	rtikolo
human_rights_un_ita_dan_64kb_0049	ɲi indˈiːrvidwo ∅a il dˈiːrritto di tʃerkˈaːre e di dʒodˈeːre in altri paesi asilo dalle persekudzioni
human_rights_un_ita_dan_64kb_0050	uesto dˈiːrritto non potra essˈeːre invokato kualora lindˈiːrvidwo sia ealmente ritʃerkato per eati non polititʃ o per adzioni kontrarie ai fini e ai printʃpi rlle adzioni nite
human_rights_un_ita_dan_64kb_0051	rtikolo
human_rights_un_ita_dan_64kb_0052	ɲi indˈiːrvidwo ∅a dˈiːrritto ad ua tʃttadinandza
human_rights_un_ita_dan_64kb_0053	essun indˈiːrvidwo potra essˈeːre arbitrariamente privato rlla sua tʃttadinandza ne rl dˈiːrritto di mutˈaːre tʃttadinandza
human_rights_un_ita_dan_64kb_0054	rtikolo
human_rights_un_ita_dan_64kb_0055	omini e donne in eta adatta ∅anno il dˈiːrritto di sposarsi e di fondˈaːre ua famiʎia sendza alkua limitadzione di radztsa tʃttadinandza o elidʒone
human_rights_un_ita_dan_64kb_0056	ssi ∅anno euɲɲuali dˈiːrritti ridʒuardo al matrimonio durante il matrimonio e allatto rl suo ʃoʎimento
human_rights_un_ita_dan_64kb_0057	l matrimonio potra essˈeːre konkluso soltanto kon il libero e pieno konsenso ri futuri konʃuɡi
human_rights_un_ita_dan_64kb_0058	a famiʎia ɛ il nwkleo aturale e fondamentale rlla sotʃeta e ∅a dˈiːrritto ad essˈeːre protetta dalla sotʃeta e dallo tato
human_rights_un_ita_dan_64kb_0059	rtikolo
human_rights_un_ita_dan_64kb_0060	ɲi indˈiːrvidwo ∅a il dˈiːrritto ad avˈeːre ua proprieta sua persoale o in komune kon altri
human_rights_un_ita_dan_64kb_0061	essun indˈiːrvidwo potra essˈeːre arbitrariamente privato rlla sua proprieta
human_rights_un_ita_dan_64kb_0062	rtikolo
human_rights_un_ita_dan_64kb_0063	ɲi indˈiːrvidwo ∅a dˈiːrritto alla liberta di pensiero di koʃendza e di elidʒone
human_rights_un_ita_dan_64kb_0064	tale dˈiːrritto inklur la liberta di kambjˈaːre di elidʒone o di kredo e la liberta di manifˈɛndstˈaːre isolatamente o in komune e sia in pbbliko ke in privato la propria elidʒone o il proprio kredo nellinseuɲɲamento nelle pratike nel kulto e nellosservandza ri riti
human_rights_un_ita_dan_64kb_0065	rtikolo
human_rights_un_ita_dan_64kb_0066	ɲi indˈiːrvidwo ∅a dˈiːrritto alla liberta di opinione e di espessione inkluso il dˈiːrritto di non essˈeːre molestato per la propria opinione e kuello di tʃerkˈaːre ritʃevˈeːre e dˈiːrffoere informadzioni e ire attraverso oɲi metsdzo e sendza ridʒuardo a frontiˈeːre
human_rights_un_ita_dan_64kb_0067	rtikolo
human_rights_un_ita_dan_64kb_0068	ɲi indˈiːrvidwo ∅a dˈiːrritto alla liberta di rʃnione e di assotʃadzione patʃfjka
human_rights_un_ita_dan_64kb_0069	essuno pɔ essˈeːre kostetto a far parte di uassotʃadzione
human_rights_un_ita_dan_64kb_0070	rtikolo
human_rights_un_ita_dan_64kb_0071	ɲi indˈiːrvidwo ∅a dˈiːrritto di partetʃpˈaːre al dʒoverno rl proprio paese sia dˈiːrettamente sia attraverso rappesentanti liberamente ʃɛlti
human_rights_un_ita_dan_64kb_0072	ɲi indˈiːrvidwo ∅a dˈiːrritto di atʃtʃedˈeːre in kondˈiːrdzioni di euɲɲuaʎiandza ai pbblitʃ impieɡi rl proprio paese
human_rights_un_ita_dan_64kb_0073	a volonta popolˈaːre ɛ il fondamento rllautorita rl dʒoverno
human_rights_un_ita_dan_64kb_0074	tale volonta rve essˈeːre espessa attraverso periodˈiːrke e veritiˈeːre eledzioni effˈɛndttuate a suffradʒo universale ed euɡuale ed a voto seɡeto o sekondo ua prokedura ekuivalente di libera votadzione
human_rights_un_ita_dan_64kb_0075	rtikolo
human_rights_un_ita_dan_64kb_0076	ɲi indˈiːrvidwo in kuanto membro rlla sotʃeta ∅a dˈiːrritto alla sikuedztsa sotʃale nonke alla ealitsdzadzione attraverso lo sfordzo adzioale e la kooperadzione interadzioale ed in rapporto kon loruɲɲanitsdzadzione e le risorse di oɲi tato ri dˈiːrritti ekonomitʃ sotʃali e kulturali indˈiːrspensabili alla sua dˈiːrɲita ed al libero sviluppo rlla sua persoalita
human_rights_un_ita_dan_64kb_0077	rtikolo
human_rights_un_ita_dan_64kb_0078	ɲi indˈiːrvidwo ∅a dˈiːrritto al lavoro alla libera ʃɛlta rllimpieuɡo a dʒuste e soddˈiːrsfatʃenti kondˈiːrdzioni di lavoro ed alla protedzione kontro la dˈiːrsokkupadzione
human_rights_un_ita_dan_64kb_0079	ɲi indˈiːrvidwo sendza dˈiːrʃriminˈaːrdzione ∅a dˈiːrritto ad euɡuale etribudzione per euɡuale lavoro
human_rights_un_ita_dan_64kb_0080	ɲi indˈiːrvidwo ke lavora ∅a dˈiːrritto ad ua rimuneradzione ekua e soddˈiːrsfatʃente ke assikuri a lui stesso e alla sua famiʎia ua esistendza konforme alla dˈiːrɲita umana ed inteɡrata se netʃessario da altri metsdzi di protedzione sotʃale
human_rights_un_ita_dan_64kb_0081	ɲi indˈiːrvidwo ∅a dˈiːrritto di fondˈaːre ri sindakati e di arrirvi per la dˈiːrfˈɛndsa ri propri inteessi
human_rights_un_ita_dan_64kb_0082	rtikolo
human_rights_un_ita_dan_64kb_0083	ɲi indˈiːrvidwo ∅a dˈiːrritto al riposo ed allo svauɡo komprˈɛnderndo in tʃɔ ua radʒonevole limitadzione rlle oe di lavoro e fˈɛndrie periodˈiːrke etribuite
human_rights_un_ita_dan_64kb_0084	rtikolo
human_rights_un_ita_dan_64kb_0085	ɲi indˈiːrvidwo ∅a dˈiːrritto ad un tenoe di vita suffjtʃente a dʒarantˈiːre la salute e il benessˈeːre proprio e rlla sua famiʎia kon partikolˈaːre ridʒuardo allalimentadzione al vestiario allabitadzione e alle kue medˈiːrke e ai servidzi sotʃali netʃessari
human_rights_un_ita_dan_64kb_0086	ed ∅a dˈiːrritto alla sikuedztsa in kaso di dˈiːrsokkupadzione malattia invalidita vedovandza vekkjˈaːria o in altro kaso di perdita di metsdzi di sussistendza per tʃrkostandze indˈiːrpˈɛndernti dalla sua volonta
human_rights_un_ita_dan_64kb_0087	a maternita e linfandzia ∅anno dˈiːrritto a spetʃali kue ed assistendza
human_rights_un_ita_dan_64kb_0088	utti i bambini ati nel matrimonio o fwori di esso rvono dʒodˈeːre rlla stessa protedzione sotʃale
human_rights_un_ita_dan_64kb_0089	rtikolo
human_rights_un_ita_dan_64kb_0090	ɲi indˈiːrvidwo ∅a dˈiːrritto allistrudzione
human_rights_un_ita_dan_64kb_0091	istrudzione rve essˈeːre ɡratuita almeno per kuanto riuɲɲuarda le klassi elementari e fondamentali
human_rights_un_ita_dan_64kb_0092	istrudzione elementˈaːre rve essˈeːre obbliuɡatoria
human_rights_un_ita_dan_64kb_0093	istrudzione teknika e profˈɛndssioale rve essˈeːre messa alla portata di tutti e listrudzione superioe rve essˈeːre eɡualmente atʃtʃessibile a tutti sulla base rl merito
human_rights_un_ita_dan_64kb_0094	istrudzione rve essˈeːre indiridztsata al pieno sviluppo rlla persoalita umana ed al raffordzamento rl rispetto ri dˈiːrritti umani e rlle liberta fondamentali
human_rights_un_ita_dan_64kb_0095	ssa rve promwovˈeːre la komprensione la tollerandza lamitʃdzia fra tutte le adzioni i ɡruppi radztsiali e elidʒosi e rve favorˈiːre lopera rlle adzioni nite per il mantenimento rlla patʃe
human_rights_un_ita_dan_64kb_0096	dʒenitori ∅anno dˈiːrritto di priorita nella ʃɛlta rl dʒenˈeːre di istrudzione da impartˈiːre ai loro fjʎi
human_rights_un_ita_dan_64kb_0097	rtikolo
human_rights_un_ita_dan_64kb_0098	ɲi indˈiːrvidwo ∅a dˈiːrritto di prˈɛndere parte liberamente alla vita kulturale rlla komunita di dʒodˈeːre rlle arti e di partetʃpˈaːre al proɡesso ʃentifjko ed ai suoi benefjtʃ
human_rights_un_ita_dan_64kb_0099	ɲi indˈiːrvidwo ∅a dˈiːrritto alla protedzione rʎi inteessi morali e materiali rrivanti da oɲi produdzione ʃentifjka letteraria e artistika di kui eʎi sia autoe
human_rights_un_ita_dan_64kb_0100	rtikolo
human_rights_un_ita_dan_64kb_0101	ɲi indˈiːrvidwo ∅a dˈiːrritto ad un ordine sotʃale e interadzioale nel kuale i dˈiːrritti e le liberta enwntʃˈaːrti in kuesta ikjˈaːrradzione possano essˈeːre pieamente ealidztsati
human_rights_un_ita_dan_64kb_0102	rtikolo
human_rights_un_ita_dan_64kb_0103	ɲi indˈiːrvidwo ∅a ri doveri verso la komunita nella kuale soltanto ɛ possibile il libero e pieno sviluppo rlla sua persoalita
human_rights_un_ita_dan_64kb_0104	ellesertʃdzio ri suoi dˈiːrritti e rlle sue liberta oɲuno rve essˈeːre sottoposto soltanto a kuelle limitadzioni ke sono stabilite dalla ledʒdʒe per assikurˈaːre il rikonoʃmento e il rispetto ri dˈiːrritti e rlle liberta rʎi altri e per soddˈiːrsfˈaːre le dʒuste esidʒendze rlla morale rllordine pbbliko e rl benessˈeːre dʒenerale in ua sotʃeta rmokratika
human_rights_un_ita_dan_64kb_0105	uesti dˈiːrritti e kueste liberta non possono in nessun kaso essˈeːre esertʃtati in kontrasto kon i fini e printʃpi rlle adzioni nite
human_rights_un_ita_dan_64kb_0106	rtikolo
human_rights_un_ita_dan_64kb_0107	ulla nella pesente ikjˈaːrradzione pɔ essˈeːre interpetato nel senso di implikˈaːre un dˈiːrritto di un kualsiasi tato ɡruppo o persoa di esertʃtˈaːre uattivita o di kompiˈeːre un atto mirante alla dˈiːrstrudzione di alkuno ri dˈiːrritti e rlle liberta in essa enwntʃˈaːrti
