human_rights_un_bug_brc_64kb_0001	
human_rights_un_bug_brc_64kb_0002	ɪninnna ropa tau ri dʒədʒeŋɪŋŋe ri lenɔɛ pəda nəppunnai memannɪ haxək tətɔŋɪŋ marilalennə reasɛŋ ropa tau ssɛddeŋenna əŋsaaŋsəə pora nəppannɪssai reasɛŋ assematʊrosəŋ molai ləlɪŋ tɔŋennə hək hək sɪmoləŋɛnna sɪddɪ sɪddɪ ropa tau
human_rights_un_bug_brc_64kb_0003	ssemətʊrosəŋ nəolai pora napaddɪʊlɔ pʊlɛ peaɡəm ssɛddeŋenna aŋsə əŋsəɛ jɪ pamassəɪŋŋɪ attəppərɛnna bəŋsa baŋsae ri hək hək simolə dʒadʒennə padatta ropa tau jɪ pʊmmərilaleŋŋə nə əllebbereŋ əppoŋənna ri asəŋŋɛ ropa tau
human_rights_un_bug_brc_64kb_0004	ɪ ləlɪŋ də ssɪmaturusɛŋŋɪ hək hək simuladʒədʒɪnna padatta ropa tau pora napənəssa meməŋŋi ssɛddeŋenna aŋsə əŋsəɛ naseŋŋe hək hək ədɛlee pora nəppʊnaiɪ sɪddɪ sɪddɪ ropa tau
human_rights_un_bug_brc_64kb_0005	ək hək pora dipanɛssaɛŋŋɪ ɪənəritu məntʃadʒɪ rɪpunnai
human_rights_un_bug_brc_64kb_0006	ək hək simuladʒədʒɪnna padatta ropa tau ɪənatu hək tʊŋəŋ mupuwɪrɪ
human_rights_un_bug_brc_64kb_0007	arɪlaleŋŋɪ pəddisɪŋɪŋmo tɛttʊŋɪwɪ hək hək mupuwɪrɪ
human_rights_un_bug_brc_64kb_0008	aptɛttəɪ nə paməsseɪ ri ləlɛnnə əlemʊ nə pədammo ropa tau
human_rights_un_bug_brc_64kb_0009	
human_rights_un_bug_brc_64kb_0010	ʊrə rɪtembaŋ naseŋŋe depattɔŋɛŋŋɪ ri asəŋŋɛ əllebbereŋ napəndʒadʒiɛ pʊəŋ səowəe nə haxək pəda nəppunnai maneŋŋe sələsʊreŋ padatta ropa tau ɪənarɔ sɪmoləŋɛnna reasəŋŋɪ merdɛka e
human_rights_un_bug_brc_64kb_0011	deə nə atənnaŋeŋŋɛ too ri lenɔɛ
human_rights_un_bug_brc_64kb_0012	ʊrə rɪtembaŋ naseŋŋe ɡau deə nəsepakalebbɪrɪŋ pʊlɛ padatta ropa tau ɪənarɔ mantʃadʒe pəŋkaukaŋ məkəssara nədʒadʒɪənne məɡɡʊppʊ mənɪŋ ətʃtʃairɪŋŋɪ nə adʒapparʊə ri ləlɪŋ atɪna ropa tau
human_rights_un_bug_brc_64kb_0013	nə ri porɛnnʊəŋi ridʒədʒeaŋi sɪddɪ lɪnɔ naonroi̯ɪ padatta ropa tau jepanəddeŋie reasəŋŋɪ ɪnennawa mappau ədə tʊŋəŋ nə inenawə sodʒuɛ ri ʊaŋ səowəe sɪbawa ɪnennawa leppɛə pʊlɛ reasəŋŋɪ akketaurɛŋ nə tɪɡɡennekɛŋŋɪ pora mantʃadʒe sɪddɪ porənnoaŋ mərelələŋ pʊlɛ taumaɪɡae
human_rights_un_bug_brc_64kb_0014	ʊrə rɪtembaŋ naseŋŋe haxək padatta ropa tau pərɪllu reatorʊ ri ləlɛnnə sʊrɛ hokʊŋɛ nərɪkkɔ dɪ wɛddiŋ sɪddɪ sɪddɪ tau nətɛrʊtɪrusi molai ləlɪŋ səlae nə naseŋŋe ləlɪŋ madɪtʃɪŋ naʊlə makkurəɡa pətʃellirɪ sefa səlae jɪ təmməppakasetauɛ
human_rights_un_bug_brc_64kb_0015	ʊrə rɪtembaŋ naseŋŋe sipakau ripadatta məssalassorɪŋ pʊlɛ sɪddɪ nɪɡərə sɪbawa nɪɡərə laiŋne pərɪllu ri pəməsse
human_rights_un_bug_brc_64kb_0016	ʊrə rɪtembaŋ naseŋŋe ɪənarɔ aŋsə əŋsəɛ pʊlɛ ri assəddiŋɪnnə aŋsə əŋsəɛ nə ri ləlɛnnə pɪaɡəmnə pora rɪpəmassɛ atteprənna ri hək hək sɪmoləŋɛnna ropa tau ri pantʃadʒee ri ʊaŋ eowəɛ ri əppɔŋɛŋ mədətʃenna nə alləbbirɛŋna sɪddɪ sɪddɪ ropa tau nə hək hək tɪrripasɪlaiŋɪŋ pʊlɛ məkkunrai nə uranɪe
human_rights_un_bug_brc_64kb_0017	nə pora nappettuɪ molai əddətʃɛŋeŋ attowɔŋənnə rilalənna kɛmɛrdɪkaən jɪ lɪbbɪ malʊəŋŋə
human_rights_un_bug_brc_64kb_0018	ʊrə rɪtembaŋ naseŋŋe nɪɡərə nɪɡərə aŋɡɔtəɪ pora mədʒdʒantʃe molai əddətʃɛŋeŋ ri ləlɛnnə penxarɡəənnə nə penɣɔrmatənnə ri hək hək sɪmoləŋɛnna padatta ropa tau nə kəbɪbəsaŋ kəbɪbəsaŋ tʊŋɛŋŋɪ nə məssəməŋ nadʒəma sɪbawa ssɛddeŋenna aŋsə əŋsəɛ
human_rights_un_bug_brc_64kb_0019	ʊrə rɪtembaŋ naseŋŋe paddessɪŋ pədae ri hək hək nə kəbɪbəsəŋŋɪ pərɪllu məntʃadʒɪ sanrɛsɪŋ pʊlɛ dʒantʃɪ pora repauɪ ɪənatu
human_rights_un_bug_brc_64kb_0020	ʊdaŋ epoluŋ
human_rights_un_bug_brc_64kb_0021	e əppənɛsaəŋŋe
human_rights_un_bug_brc_64kb_0022	də ssemətʊrosɛnnə ək ək emʊlədʒədʒenna ʊpə au
human_rights_un_bug_brc_64kb_0023	eəsɪŋŋɪ sɪddɪ tɛttɔŋɪŋ wassele pora nəɔləɪ sɪnɪnnə aŋsə nə eɡarəɛ jɪ setodʒuə nəporənnuəŋŋɪ sɪnɪnnə ropa tau ri ləlɛnnə məʃərakaɛ
human_rights_un_bug_brc_64kb_0024	də əssema turuseŋ pora ri pandʒatʃe sanrɛsɪŋ ri ələ pakkurəɡa məssəppa pəddessɪŋeŋ jɪ pamassəɪŋŋɪ pɛnɣərɡaəŋŋə ri hək hək kɪbɪbasanna ropa taue
human_rights_un_bug_brc_64kb_0025	əssəleŋ
human_rights_un_bug_brc_64kb_0026	enɪnna ropa tau ri dʒadʒɪəŋŋe relenɔə nəppunnai mənɪŋŋɪ reasəŋŋɪ əlɛbbirɛŋ
human_rights_un_bug_brc_64kb_0027	əppunai reasəŋŋɪ əkkəleŋ nəppʊnai reasəŋŋɪ ati mərənnne nə sebole bolena pəda sepəkatau pəda məssəlasorɛŋ
human_rights_un_bug_brc_64kb_0028	əssəleŋ
human_rights_un_bug_brc_64kb_0029	enɪnna ropa tau nəppunnai mənɪŋ reasəŋŋɪ hək nə kəbɪbəsaŋ jɪ tərukɪɪ ri ləlɛnnə də ssəmatʊrosɛŋŋɛ nə dɪɡəɡə reasəŋŋɪ mappaselaiŋeŋ əppɔŋɛŋ mappaselaiŋeŋ wərɛnnə ole mappaselaiŋeŋ ʊrənɛ nə məkkunrai mappaselaiŋeŋ bəŋsa bahəsa əɡama nə əttəpperəŋ pʊletik ərɪɡa mappaselaiŋeŋ əssəleŋ ussulo baŋsana assoɡirɛnnə onro dʒadʒɪənnə ərɪɡa paŋkana
human_rights_un_bug_brc_64kb_0030	asəŋŋɛ dɪɡəɡə rɪpasɪlaiŋəŋ reasəŋŋɪ sefa pʊlɪtenə hokuŋna nə paŋkana ri ɪntɛrnasiɔnəlɛ pʊlɛ nɪɡərə ərɪɡa kəmpoŋ naonroi̯ɪ sɪddɪ tau pʊlɛ
human_rights_un_bug_brc_64kb_0031	ʊ pʊlɛ nɪɡərə jɪ mɪrdekaɛ jɪ əŋkəə wɪlaja wɪlaja wakkɪlɛnnaarɛɡa nəparɛntaə
human_rights_un_bug_brc_64kb_0032	əssələŋ
human_rights_un_bug_brc_64kb_0033	enɪnna ropa tau nəppunnai hək too ri lenɔɛ pənɪddɪŋi reasəŋŋɪ attənnəŋɪŋ nə assalamakɛŋ ri wətəkkəlena sɪddɪ sedddi tau
human_rights_un_bug_brc_64kb_0034	əssəleŋ
human_rights_un_bug_brc_64kb_0035	ɛɡaɡə reasɛŋ sɪddɪ sɪddɪ tau wɛddiŋ ri pantʃadʒe ətə nə dedaŋkaŋɪŋ topa
human_rights_un_bug_brc_64kb_0036	əsaba jɪ reasɛŋ addəŋkaŋɛŋ ətə ɪənatu ləlɪŋ səlah
human_rights_un_bug_brc_64kb_0037	əssəleŋ
human_rights_un_bug_brc_64kb_0038	ɛɡaɡə sɪddɪ tau wɛddiŋ ri səssə nə diɡaukaŋ pappədə ɔlokolɔə
human_rights_un_bug_brc_64kb_0039	əssəleŋ
human_rights_un_bug_brc_64kb_0040	enɪnna ropa tau nəppʊnai hək repəttɔŋɛŋ ri ɔlona hʊkoŋŋɪ naseŋŋe əllebbereŋ sɪddɪ sɪddɪ tau moteɡa teɡə mʊnrʊ
human_rights_un_bug_brc_64kb_0041	əssəleŋ
human_rights_un_bug_brc_64kb_0042	enɪnna ropa tau nəppʊnai hək reasəŋŋɪ sanrɛsɪŋ hokuŋ nə dɪ ɡəɡa rɪpasɪlaiŋəŋ
human_rights_un_bug_brc_64kb_0043	əppunai mənɪŋ hək pəda ri sɪnɪnnə pəŋkaukaŋ məkəssara nə mappassəɪ jɪ deə nəsɪtodʒu sɪbawa də assamətʊrusɛŋŋe nə sɪnɪnnə ədə səlae jɪ pantʃadʒee əppəssəŋ nə akkasərəkaŋŋe
human_rights_un_bug_brc_64kb_0044	əssəleŋ
human_rights_un_bug_brc_64kb_0045	enɪnna ropa tau nəpunnai hək reasəŋŋɪ makkurəɡa əddətʃɛŋeŋ ri pəŋədilan nasiɔnalə molaiɪ dʒamaŋ dʒamaŋ səla jɪ dɪ e nəsɪtodʒu hək hək mərelələŋ jɪ napʊwərə ndəŋ ndəŋ əsər nə hʊkoŋŋɪ
human_rights_un_bug_brc_64kb_0046	əssəleŋ
human_rights_un_bug_brc_64kb_0047	ɛɡaɡə sɪddɪ ropa tau wɛddiŋ ri tɪkkeŋ ri tahaŋ nə reabbeəŋ pappədə ɔlokolɔə
human_rights_un_bug_brc_64kb_0048	əssəleŋ
human_rights_un_bug_brc_64kb_0049	enɪnna ropa tau ri passamai nəppʊnai hək ri parədɪləŋ ədɛlee nə ri pəradelaŋ bəbasaɛ nə dɪ nəmatəne tʃiwale ri ləlɪŋ repattɛttɛ reasəŋŋɪ hək nə kəwadʒebaŋ kewadʒɪbənnə nə rɪlalɪŋ sɪnɪnnə tʊntʊtanna pɪdana jɪ repɛttʊəŋŋɪ
human_rights_un_bug_brc_64kb_0050	əssəleŋ
human_rights_un_bug_brc_64kb_0051	enɪnna ropa tau jɪ dɪtuntuɪ nasəba reasɛŋ məppɪɡau assaləŋ ri hʊkoŋŋɪ depə deasɛŋ səlah lɪttʊ ripabʊtteaŋŋɪ əssalanna mɛnoro hʊkoŋŋɪ rilalənna pəŋədeləŋ jɪ pəda naisseŋ mənɪŋ tauwɛ naeŋka dɪərɛŋŋi dʒəminəŋ nəppɛrellʊaŋŋɛŋŋi bɪlai əlɪna
human_rights_un_bug_brc_64kb_0052	ɛɡaɡə sɪddɪ ropa tau wɛddiŋ ripassə məppɪɡau assaləŋ hokuŋ nasəba pəŋkaukaŋ jɪ dɛɛpanatamə məntʃadʒɪ assaləŋ hokuŋ mɛnoro ndəŋ ndəŋ əsiʊnale ərɪɡa ɪntɛrnasiɔnəlɛ nərɪkkɔ jɪ pəŋkaukaŋŋe ri peɡau
human_rights_un_bug_brc_64kb_0053	ətɔ wɛddiŋ rɪpɛttu hukumənnə ləbbɪh matanɛ pʊlɛ hokuŋ jɪ sitɪnadʒaɪ pappədə rɪwəttʊnnə əssələŋŋɛ ri peɡau
human_rights_un_bug_brc_64kb_0054	əssəleŋ
human_rights_un_bug_brc_64kb_0055	enɪnna ropa tau dɪ wɛddiŋ rɪɡəŋɡu orosaŋ əlɪna kelʊarɡəna roma raŋɡana nə dɪ wɛddiŋ dɪtɛru tɛrose sʊrɛ sorena
human_rights_un_bug_brc_64kb_0056	ə lɛbbepe dɪ wɛddiŋ ri hələŋi nə ri kətʃtʃakɪ reasɛŋ sirenə tauwɛ
human_rights_un_bug_brc_64kb_0057	əsaba pora nəppʊnai hək reasəŋŋɪ sanrɛsɪŋ hokuŋ
human_rights_un_bug_brc_64kb_0058	əssəleŋ
human_rights_un_bug_brc_64kb_0059	enɪnna ropa tau nəppʊnai reasəŋŋɪ kəbɪbəsaŋ mʊnrʊ rilalənna sɪddɪ nɪɡərə
human_rights_un_bug_brc_64kb_0060	enɪnna ropa tau nəppʊnai hək mʊnrʊ ri sɪnɪnnə nəɡaraɛ məkkotɔrʊ kɔ məeloi̯ mʊnrʊ ri nɛɡarana ərɪɡa maɪlo lɪsu ri nɛɡarana
human_rights_un_bug_brc_64kb_0061	əssəleŋ
human_rights_un_bug_brc_64kb_0062	enɪnna ropa tau nəppʊnai hək massəpə nə nəpanɛddɪŋɪ reasɛŋ əkketoʊrəŋ ri nɪɡərə laiŋŋɛ nərɪkkɔ maɪlo nəsaləmakkəŋŋɪ əlɪna pʊlɛ passappənə
human_rights_un_bug_brc_64kb_0063	jəna jɪ həke dɪwɛddeŋ ri pəke rɪwɛttu ri pɪppeŋ narisəppə nasəba tʊŋəŋ tʊŋəŋ napeɡau əɡɡaukɛŋ səlae jɪ deə ɡəɡa hubuŋənnə sɪbawa pʊletik ərɪɡa napeɡau pəŋkaukaŋŋe nasəba dɛnəsɛddi ləlɪŋ sɪbawa tʊdʒuəŋ əmmʊlaŋɛnnə ssɛddeŋenna aŋsə əŋsəɛ
human_rights_un_bug_brc_64kb_0064	əssəleŋ
human_rights_un_bug_brc_64kb_0065	enɪnna ropa tauwɛ nəppona hək mantʃadʒe reasɛŋ wərɡa nɪɡərə
human_rights_un_bug_brc_64kb_0066	ɛɡaɡə sɪddɪ tau wɛddiŋ rɪtɛru tɛrose palokai kɪwarɡə nɛɡəraannə ərɪɡa dɪ dɪtərimai hakɲa səllɛɪ kɪwarɡə nɛɡəraannə
human_rights_un_bug_brc_64kb_0067	əssəleŋ
human_rights_un_bug_brc_64kb_0068	enɪnna ropa tau ʊrənɛ nə məkkʊnraiɪ jɪ məɡɡəŋkənɪ balleɡe omorunə tɪmməŋkɪ ri bətasɪ əssəleŋ baŋsana wərɡa nɛɡarana ərɪɡa əɡamana nəppʊnai hək reasəŋŋɪ nekkah nə nəpunnai sɪddɪ sɪddɪ kɪloarɡə
human_rights_un_bug_brc_64kb_0069	anəto pəda nəpunnai hək jɪ e tɪddipasɪlaiŋɪŋ ri ləlɪŋ perkawinənna nə rɪwɛttu nə ləleŋɪ perkawinənna nə rɪwəttʊnnə məeloi̯ sitellɪrəŋ
human_rights_un_bug_brc_64kb_0070	ɛɡaɡə reasɛŋ passaŋ rilalənna perkəwenaŋŋɪ pəppɪlənəpi ɛlɔnəpe nə sɪtudʒʊɪpe məkkʊnraiɪ nə ʊrənɛ
human_rights_un_bug_brc_64kb_0071	eəsɪŋŋɪ kɪloarɡə rɪpassɛdde reasəŋŋɪ əppəseddeəŋ mərelələŋ pʊlɛ məʃərakaɛ nənəponnai hək sanrɛsɪŋ pʊlɛ məʃərakaɛ nə nəɡaraɛ
human_rights_un_bug_brc_64kb_0072	əssəleŋ
human_rights_un_bug_brc_64kb_0073	enɪnna ropa tauwɛ nəppʊnai hək reasəŋŋɪ assoɡirɪŋ nə wəraŋpəraŋ mɔ nəpponnaŋe sɪddɪ tau ərɪɡa nəpponnaŋe sɪbawa tau laiŋŋɛ
human_rights_un_bug_brc_64kb_0074	ɛɡaɡə sɪddɪ ropa tau wɛddiŋ ripassə malai assoɡirɛnnə nə wərəŋparanna
human_rights_un_bug_brc_64kb_0075	əssəleŋ
human_rights_un_bug_brc_64kb_0076	enɪnna ropa tau nəppʊnai hək reasəŋŋɪ kəbɪbəsaŋ ri ləlɪŋ mappikkerɪ pəttɛnnaŋ atinnə nə əɡamana ərɪɡa lɪtʃtʃɪ əɡama nə əttəpperəŋ nə kəbɪbəsaŋ pənəssai əɡama nə atteprənna ərɪɡa nəpaɡɡoroəŋŋi nə nəlaləŋe
human_rights_un_bug_brc_64kb_0077	reɡə naʊlə mənɪŋŋɪ adʒarəŋ əɡamana mɔ tʃoələ əlɪna ərɪɡa məssamaŋŋɪ sɪbawa tau laiŋŋɛ
human_rights_un_bug_brc_64kb_0078	ɪ ɔlona tau məeɡaɛ ərɪɡa tʃoələ əlɪna
human_rights_un_bug_brc_64kb_0079	əssəleŋ
human_rights_un_bug_brc_64kb_0080	enɪnna ropa tauwɛ nəppʊnai mənɪŋ reasəŋŋɪ hək nə kəbɪbəsaŋ mampau ədə naseŋŋe tʊŋəŋ
human_rights_un_bug_brc_64kb_0081	anəro hək e mʊttəmə tʊni rilalənna kəbɪbəsaŋ nəppʊnai pendapət tɪnriɡəŋɡu mɔ repau rilalənna sɪnɪnnə beritaɪ
human_rights_un_bug_brc_64kb_0082	əssəleŋ
human_rights_un_bug_brc_64kb_0083	enɪnna ropa tauwɛ nəppʊnai reasəŋŋɪ hək nə kəbɪbəsaŋ sɪpoluŋ nə pəda tudəŋ sɪpoluŋ
human_rights_un_bug_brc_64kb_0084	ɛɡaɡə sɪddɪ tau wɪddɪ depassaŋəŋi təma rilalənna sɪddɪ assipʊloŋeŋɪ
human_rights_un_bug_brc_64kb_0085	əssəleŋ
human_rights_un_bug_brc_64kb_0086	enɪnna ropa tau nəppʊnai hək matʃtʃoɪ rilalənna pɛmɛrintahan nɛɡarana ləŋsʊŋnɛ ərɪɡa pʊlɛ wakkele wakkele pʊraɪ nəpileɪ
human_rights_un_bug_brc_64kb_0087	enɪnna ropa tau pəda nəppʊnai hək nə kɪsɛmpətaŋ rɪpəɛnrɛ paŋkana pʊlɛ pɛmɛrintahan nɛɡarana
human_rights_un_bug_brc_64kb_0088	kkəlorenna taumeɡəɪ sebole bolena mantʃadʒe sanrɛsɪŋ akkʊasana pɛmerentəɪ akkɛlʊreŋŋɛ jɪdɪ sebole bʊlɛ rɪpələbbaŋe rɪlalɪŋ ɛmelɪhan mum jɪ rɪpiɡau ri wɪttʊ pʊraɪ ripatentʊŋe nəhadəre mənɪŋ nə naisseŋ mənɪŋ tau məeɡaɛ
human_rights_un_bug_brc_64kb_0089	reɡə əŋka tʃəra jɪ wɪddiŋɪŋŋi rɪdʒəmɪŋŋe kɪbɪbasanna məppilɛ
human_rights_un_bug_brc_64kb_0090	əssəleŋ
human_rights_un_bug_brc_64kb_0091	enɪnna ropa tau reasəŋŋɪ əŋɡota masərakəɛ nəppʊnai hək appʊnəŋɪŋ əssələsoreŋɛŋ əde nə allebereŋ jɪ naporennuaŋ mənɪŋ reasəŋŋɪ ropa tau wɛddiŋ rɪolə reasəŋŋɪ makkurəɡa ri ləlɪŋ baŋsata mɔribəŋsə laiŋŋɛ ri lenɔɛ
human_rights_un_bug_brc_64kb_0092	ebawə jɪ deə nəsɪsələŋ reasɛŋ peratʊrənnə sɪddɪ nɪɡərə
human_rights_un_bug_brc_64kb_0093	əssəleŋ
human_rights_un_bug_brc_64kb_0094	enɪnna ropa tauwɛ nəppʊnai hək reasɛŋ adʒdʒaməŋ nəppʊnai hək məppilɛ dʒamaŋ nəppʊnai hək jɪ rilalənna ʃərə ʃərə dʒamaŋŋɛ jɪ ədɛlee jɪ məppɪsarʊɪ nasibɔlɪ bolena əŋka nəttʊəŋəŋ kɔ dɪ ɡəɡa dʒəma dʒamanna
human_rights_un_bug_brc_64kb_0095	enɪnna ropa tau tewwəddiŋ dɪpasɪlaiŋəŋ nəppʊnai mənɪŋ hək rʊntʊ wassele papəda ɛɡanə nərɪkkɔ pappədə dʒamaŋ dʒamanna
human_rights_un_bug_brc_64kb_0096	enɪnna ropa tau mədʒdʒamaə nəppʊnai hək pənəddeŋɪwɪ wassele ədɛlee nə məppɪsarʊɪ jɪ wɛddɪŋi pədatʃəŋe nə pəlebbirɪ əttʊwoŋənə ri əlɪna nə kelʊarɡəna nərɪkkɔ pərɪllu nəpunnai reasəŋŋɪ assənrəseŋ əddətʃɛŋeŋ jɪ weddɪŋŋɪ nattʊaŋaŋ ri ləlɪŋ laiŋŋɛ
human_rights_un_bug_brc_64kb_0097	enɪnna ropa tau nəppunnai hək pətɪttʊŋi ərɪɡa mʊttəmə rilalənna ɛrɪkat sərikat pəkɛrdʒaə koɛlʊi nəlendoŋɪ kɛpɛntɪŋənna
human_rights_un_bug_brc_64kb_0098	əssəleŋ
human_rights_un_bug_brc_64kb_0099	enɪnna ropa tau nəppʊnai hək reasɛŋ attənnəŋɪŋ nə pəkanse sɪbawa ripəttɛntʊe wɛttunnə ədʒamaŋŋɛ nə wɪttʊ pəkansee nə tɪttɪ nataremə ɡadʒennə
human_rights_un_bug_brc_64kb_0100	əssəleŋ
human_rights_un_bug_brc_64kb_0101	enɪnna ropa tau nəppʊnai hək pənɪddɪŋi e reasɛŋ əddətʃɛŋeŋ tʊwɔ relenɔə attənnəŋɪŋ ri ləlɪŋ əlɪna sɪbawa kelʊarɡəna
human_rights_un_bug_brc_64kb_0102	uttama tʊni reasɛŋ hək ri si nenna wɛddiŋ nəpakeɪ pakɛannə bʊlana nəsɪninna pabburəna kɔ məlasai ərɪɡa sɪnɪnnə pədʒdʒəmpa jɪ nəparɛluəŋɛŋŋi nə nəppʊnai tɔ hək reasəŋŋɪ dʒamɪnən nərɪkkɔ dɪɡəɡə dʒamaŋ dʒamanna nərɪkkɔ məlasai nərɪkkɔ səla salaŋaŋe ərɪɡa sɪnɪnnə wɪttʊ jɪ mappəntʃadʒɪɪ kurannə wassəlɪnə əssəleŋ tɛnnɪja jɪ nəttʊŋkaije
human_rights_un_bug_brc_64kb_0103	ndɔnə nə ənə ənəə nəppʊnai hək lolɔŋanŋi reasəŋŋɪ pamməsə nə bantʊaŋ məlɛbbɪɪ sɪnɪnnə ənə ənəə jɪ redʒadʒeəŋŋi ri ləlɛnnə kɪloarɡə madɛtʃɛŋŋe ərɪɡa ri dʒədʒɪaŋ məntʃadʒɪ ənə bʊlɛ
human_rights_un_bug_brc_64kb_0104	arɪllo rɪəsɛŋŋi əddətʃɛŋeŋ towɔŋ nə tɪddipasɪlaiŋɪŋ
human_rights_un_bug_brc_64kb_0105	əssəleŋ
human_rights_un_bug_brc_64kb_0106	enɪnna ropa tau nəppʊnai hək pənɪddɪŋi reasəŋŋɪ məssikolə
human_rights_un_bug_brc_64kb_0107	eəsɪŋŋɪ məssəppa pəddessɪŋeŋ ri ləlɛnnə əssekoləŋŋɛ denə pərɪllu di wədʒa sebole bʊlɛ rɪwəttʊnnə mappəmolə sikolə nə pəndedekən dasarɛ
human_rights_un_bug_brc_64kb_0108	mmuləŋɪnnə məssekolaɪ pərɪllu ri wadʒɪbkən
human_rights_un_bug_brc_64kb_0109	e assɪkoləŋ tɛknɪe nə kədʒʊroəŋŋe pərɪllu nətəmaki mənɪŋ tauwɛ mappakkʊtʊrɔ reasəŋŋɪ assɪkoləŋ mətənre kɔparɪllʊ nətəmaki mənɪŋ sɪnɪnnə tauwɛ nərɪkkɔ wɛddiŋ tʃʊtʃɔ
human_rights_un_bug_brc_64kb_0110	ssikʊləŋŋe pərɪllu repəttudʒo nasəba ɪənatu əddətʃɛŋeŋ realɛna sɪddɪ tau nə pəda meta dɪtʃeŋ
human_rights_un_bug_brc_64kb_0111	əddɪsəŋɪŋ jɪ reəppoe riəssekɔləŋə ɪənəritɔ pantʃadʒe ropa tauwɛ pəda sipakalebbereŋ pəda sepəkaməsɛ ripadanna senna baŋsae
human_rights_un_bug_brc_64kb_0112	ə narʊ reasəŋŋɪ tau matʊə nəppʊnai hək nə pərɪllu nə pɪləəŋəŋŋɪ sikolə jɪ kera kera tʃɔtʃʊŋŋi nʊlaɪ pəda ənə ənana
human_rights_un_bug_brc_64kb_0113	əssəleŋ
human_rights_un_bug_brc_64kb_0114	enɪnna ropa tau nəppʊnai hək molai ləlɪŋ abbiəsaŋ əde ri ləlɛnnə məʃərakaɛ nəpanɛddeŋɪwɪ reasɛŋ eloŋ kɛlʊŋ nə nəpanɛddɪŋɪ tʊi reasəŋŋɪ addeəɛtʃɛŋɛŋ nə ɡʊnana əssekoləŋŋɛ
human_rights_un_bug_brc_64kb_0115	ə narʊ ropa tau nəppʊnai hək reasəŋŋɪ lʊlʊŋan pɛrlendoŋanŋ nə əddɛtʃɪŋŋeŋ reasəŋŋɪ attuɔŋ ri lenɔɛ nə ri əhɛrəɪ
human_rights_un_bug_brc_64kb_0116	əssəleŋ
human_rights_un_bug_brc_64kb_0117	enɪnna ropa tau nəppʊnai hək ri asəŋŋɛ əddətʃɛŋeŋ tʊwɔ ri lenɔɛ nə sɪnɪnnə hək kebɪbasan pora tərukɪ mənɪŋ ri ləlɪŋ nə ədə assatʊruseŋ nə sebole bolena realə sanrɛsɪŋ
human_rights_un_bug_brc_64kb_0118	əssəleŋ
human_rights_un_bug_brc_64kb_0119	enɪnna ropa tau nəppʊnai reasɛŋ kɪwadʒibən ri məʃərəka ʊnrɔŋnə mʊnrʊ tʊwɛ pəwekkɛmaneŋ sɪnɪnnə əlɛbbirɛŋ realɛna
human_rights_un_bug_brc_64kb_0120	iləlɪleŋ ri paddupəna reasəŋŋɪ həxəknə kəbɪbəsəŋŋɪ sɪnɪnnə ropa tauwɛ pəɪrlu tʊnrʊ rebatasəŋ tanraŋ pʊraɪ ripatɪntoaŋ ri ʊndaŋundəŋŋɛ jɪ todʒuanna nə dʒəmeŋ mənɪŋ ri əsɪŋŋŋɪ ədə tɔŋŋeŋ nə əlləbbirəŋ ri həxəknə kɪbɪbasanna tɔ laiŋŋɛ
human_rights_un_bug_brc_64kb_0121	ə nəritʊ ri asəŋŋɛ haxək nə kəbɪbəsəŋŋɪ tɪmməka wɛddɪŋi rɪolə nərɪkkɔ denə si məturʊ sɪbawa tudʒuəənna nə pɪɪnsɪpnə ssemətʊrosɛnnə bəŋsabəŋsəɛ
human_rights_un_bug_brc_64kb_0122	əssəleŋ
human_rights_un_bug_brc_64kb_0123	ɛɡaɡə mɔ sɪddɪ rilalənna ədə assamətʊrusɛŋŋe nəpəlalɔ ri tafsir nasəŋɡŋɪ dɪbokkaŋ ləlɪŋ sɪddɪ nɪɡərə kɪlɔmpk ɪjə ɡə sɪddɪ ropa tau nəppʊnai hək natɛro tɛrrose naseŋŋe məppɪɡau pəŋkaukaŋ səlae jɪ wɛddiŋ nə sʊləŋe reasəŋŋɪ əlləbbererɛnnə həxəknə kəbɪbəsaŋ kəbɪbəsaŋ jɪ tərukɪɪ ri ləlɛnnə ədə əssatʊruseŋŋe
