human_rights_un_fin_jf_64kb_0001	yhdist̪yneiden kɑnsɑkunt̪ien kolmɑs yleiskokous hyʋæksyi jɑ julkist̪i ihmisoikeuksien yleismɑɑilmɑllisen julist̪uksen joulukuun
human_rights_un_fin_jf_64kb_0002	pæiʋænæ
human_rights_un_fin_jf_64kb_0003	julist̪uksen hyʋæksymisen puolest̪ɑ æænest̪i mɑɑt̪ɑ
human_rights_un_fin_jf_64kb_0004	mikææn mɑɑ ei æænest̪ænyt̪ ʋɑst̪ɑɑn
human_rights_un_fin_jf_64kb_0005	kɑhdeksɑn mɑɑt̪ɑ pidæt̪t̪yi æænest̪æmæst̪æ
human_rights_un_fin_jf_64kb_0006	ʋælit̪t̪ømæst̪i t̪æmæn hist̪oriɑllisen t̪ɑpɑht̪umɑn jælkeen yleiskokous kehot̪t̪i kɑikkiɑ jæsenmɑit̪ɑ julkɑisemɑɑn julist̪uksen t̪ekst̪in
human_rights_un_fin_jf_64kb_0007	niit̪æ pyydet̪t̪iin leʋit̪t̪æmææn jɑ t̪ekemææn sit̪æ t̪unnet̪uksi lukemɑɑn jɑ selit̪t̪æmææn sit̪æ ennen kɑikkeɑ kouluissɑ jɑ muissɑ oppilɑit̪oksissɑ eri mɑiden jɑ ɑlueiden poliit̪t̪isist̪ɑ oloist̪ɑ riippumɑt̪t̪ɑ
human_rights_un_fin_jf_64kb_0008	julist̪uksen ʋirɑllinen t̪ekst̪i on sɑɑt̪ɑʋissɑ ykn kuudellɑ ʋirɑllisellɑ kielellæ ɑrɑpiɑksi eŋlɑnniksi espɑnjɑksi kiinɑksi rɑnskɑksi jɑ ʋenæjæksi
human_rights_un_fin_jf_64kb_0009	myøs monet̪ ykn jæsenmɑɑt̪ oʋɑt̪ noudɑt̪t̪ɑneet̪ yleiskokouksen kehot̪ust̪ɑ jɑ kæænt̪æneet̪ julist̪uksen omɑlle kielelleen
human_rights_un_fin_jf_64kb_0010	seurɑɑʋillɑ siʋuillɑ oleʋɑ kæænnøs on suomen hɑllit̪uksen ʋɑhʋist̪ɑmɑ
human_rights_un_fin_jf_64kb_0011	julist̪uksen ilmɑiskɑppɑleit̪ɑ on sɑɑt̪ɑʋɑnɑ ykn køøpenhɑminɑssɑ sijɑit̪seʋɑst̪ɑ pohjoismɑisest̪ɑ t̪iedot̪ust̪oimist̪ost̪ɑ ykn ʋirɑllisillɑ kielillæ pohjoismɑisillɑ kielillæ jɑ rɑjɑllinen mææræ muillɑ kielillæ
human_rights_un_fin_jf_64kb_0012	ihmisoikeuksien yleismɑɑilmɑllinen julist̪us
human_rights_un_fin_jf_64kb_0013	johdɑnt̪o
human_rights_un_fin_jf_64kb_0014	kun ihmiskunnɑn kɑikkien jæsent̪en luonnollisen ɑrʋon jɑ heidæn yht̪ælæist̪en jɑ luoʋut̪t̪ɑmɑt̪t̪omien oikeuksiensɑ t̪unnust̪ɑminen on ʋɑpɑuden oikeudenmukɑisuuden jɑ rɑuhɑn perust̪ɑnɑ mɑɑilmɑssɑkun ihmisoikeuksiɑ on ʋæheksyt̪t̪y t̪ɑi ne on jæt̪et̪t̪y huomiot̪ɑ ʋɑille on t̪ɑpɑht̪unut̪ rɑɑkɑlɑist̪ekojɑ jot̪kɑ oʋɑt̪ jærkyt̪t̪æneet̪ ihmiskunnɑn omɑɑt̪unt̪oɑ jɑ kun kɑnsojen korkeimmɑksi pææmææræksi on julist̪et̪t̪u sellɑisen mɑɑilmɑn luominen missæ ihmiset̪ ʋoiʋɑt̪ ʋɑpɑɑst̪i nɑut̪t̪iɑ sɑnɑn jɑ uskon ʋɑpɑut̪t̪ɑ sekæ elææ ʋɑpɑinɑ pelost̪ɑ jɑ puut̪t̪eest̪ɑkun on ʋælt̪t̪æmæt̪ønt̪æ et̪t̪æ ihmisoikeudet̪ t̪urʋɑt̪ɑɑn oikeusjærjest̪yksellæ jot̪t̪ɑ ihmist̪en ei olisi pɑkko ʋiimeisenæ keinonɑ noust̪ɑ kɑpinɑɑn pɑkkoʋɑlt̪ɑɑ jɑ sort̪oɑ ʋɑst̪ɑɑnkun on t̪æhdellist̪æ edist̪ææ yst̪æʋællist̪en suht̪eiden kehit̪t̪ymist̪æ kɑnsojen ʋælillekun yhdist̪yneiden kɑnsɑkunt̪ien kɑnsɑt̪ oʋɑt̪ peruskirjɑssɑ ʋɑhʋist̪ɑneet̪ uskonsɑ ihmist̪en perusoikeuksiin ihmisyksiløn ɑrʋoon jɑ merkit̪ykseen sekæ miest̪en jɑ nɑist̪en yht̪ælæisiin oikeuksiin jɑ kun ne oʋɑt̪ ilmɑisseet̪ ʋɑkɑɑn t̪ɑht̪onsɑ edist̪ææ sosiɑɑlist̪ɑ kehit̪yst̪æ jɑ pɑrempien elæmisen eht̪ojen ɑikɑɑnsɑɑmist̪ɑ ʋɑpɑɑmmissɑ oloissɑkun jæsenʋɑlt̪iot̪ oʋɑt̪ sit̪out̪uneet̪ edist̪æmææn yht̪eist̪oiminnɑssɑ yhdist̪yneet̪ kɑnsɑkunnɑt̪ jærjest̪øn kɑnssɑ ihmisoikeuksien jɑ perusʋɑpɑuksien yleist̪æ kunnioit̪t̪ɑmist̪ɑ jɑ noudɑt̪t̪ɑmist̪ɑ jɑkun yht̪einen kæsit̪ys næiden oikeuksien jɑ ʋɑpɑuksien sisælløst̪æ on mit̪æ t̪ærkein t̪æmæn sit̪oumuksen t̪æydelliselle t̪ot̪eut̪t̪ɑmiselle
human_rights_un_fin_jf_64kb_0015	niin sen ʋuoksi
human_rights_un_fin_jf_64kb_0016	yleiskokousɑnt̪ɑɑ t̪æmæn ihmisoikeuksien yleismɑɑilmɑllisen julist̪uksen kɑikkien kɑnsojen jɑ kɑikkien kɑnsɑkunt̪ien t̪ɑʋoit̪elt̪ɑʋɑksi yht̪eiseksi ohjeeksi jot̪t̪ɑ kukin yksilø jɑ kukin yht̪eiskunt̪ɑelin pyrkisi pit̪æen ɑlɑt̪i mielessææn t̪æmæn julist̪uksen ʋɑlist̪ɑmɑllɑ jɑ opet̪t̪ɑmɑllɑ edist̪æmææn næiden oikeuksien jɑ ʋɑpɑuksien kunnioit̪t̪ɑmist̪ɑ sekæ t̪urʋɑɑmɑɑn jɑt̪kuʋin kɑnsɑllisin jɑ kɑnsɑinʋælisin t̪oimenpit̪ein niiden yleisen jɑ t̪ehokkɑɑn t̪unnust̪ɑmisen jɑ noudɑt̪t̪ɑmisen sekæ it̪se jæsenʋɑlt̪ioiden kɑnsojen et̪t̪æ niiden oikeuspiirissæ oleʋien ɑlueiden kɑnsojen keskuudessɑ
human_rights_un_fin_jf_64kb_0017	
human_rights_un_fin_jf_64kb_0018	ɑrt̪iklɑ
human_rights_un_fin_jf_64kb_0019	kɑikki ihmiset̪ synt̪yʋæt̪ ʋɑpɑinɑ jɑ t̪ɑsɑʋert̪ɑisinɑ ɑrʋolt̪ɑɑn jɑ oikeuksilt̪ɑɑn
human_rights_un_fin_jf_64kb_0020	heille on ɑnnet̪t̪u jærki jɑ omɑt̪unt̪o jɑ heidæn on t̪oimit̪t̪ɑʋɑ t̪oisiɑɑn koht̪ɑɑn ʋeljeyden heŋessæ
human_rights_un_fin_jf_64kb_0021	
human_rights_un_fin_jf_64kb_0022	ɑrt̪iklɑ
human_rights_un_fin_jf_64kb_0023	jokɑinen on oikeut̪et̪t̪u kɑikkiin t̪æssæ julist̪uksessɑ esit̪et̪t̪yihin oikeuksiin jɑ ʋɑpɑuksiin ilmɑn minkæænlɑist̪ɑ rot̪uun ʋæriin sukupuoleen kieleen uskont̪oon poliit̪t̪iseen t̪ɑi muuhun mielipit̪eeseen kɑnsɑlliseen t̪ɑi yht̪eiskunnɑlliseen ɑlkuperææn omɑisuut̪een synt̪yperææn t̪ɑi muuhun t̪ekijææn perust̪uʋɑɑ erot̪ust̪ɑ
human_rights_un_fin_jf_64kb_0024	mit̪ææn erot̪ust̪ɑ ei myøskææn pidæ t̪ehdæ sen mɑɑn t̪ɑi ɑlueen ʋɑlt̪iollisen hɑllinnollisen t̪ɑi kɑnsɑinʋælisen ɑsemɑn perust̪eellɑ johon henkilø kuuluu olipɑ t̪æmæ ɑlue it̪senæinen huolt̪ohɑllinnossɑ it̪sehɑllint̪oɑ ʋɑillɑ t̪ɑi t̪æysiʋɑlt̪ɑisuudelt̪ɑɑn minkæ t̪ɑhɑnsɑ muun rɑjoit̪uksen ɑlɑinen
human_rights_un_fin_jf_64kb_0025	
human_rights_un_fin_jf_64kb_0026	ɑrt̪iklɑ
human_rights_un_fin_jf_64kb_0027	kullɑkin yksiløllæ on oikeus elæmææn ʋɑpɑut̪een jɑ henkiløkoht̪ɑiseen t̪urʋɑllisuut̪een
human_rights_un_fin_jf_64kb_0028	
human_rights_un_fin_jf_64kb_0029	ɑrt̪iklɑ
human_rights_un_fin_jf_64kb_0030	ket̪ææn ei sɑɑ pit̪ææ orjɑnɑ t̪ɑi orjuut̪et̪t̪unɑ kɑikki orjuuden jɑ orjɑkɑupɑn muodot̪ on kiellet̪t̪æʋæ
human_rights_un_fin_jf_64kb_0031	
human_rights_un_fin_jf_64kb_0032	ɑrt̪iklɑ
human_rights_un_fin_jf_64kb_0033	ket̪ææn ei sɑɑ kidut̪t̪ɑɑ eikæ kohdellɑ t̪ɑi rɑŋɑist̪ɑ julmɑst̪i epæinhimillisest̪i t̪ɑi ɑlent̪ɑʋɑst̪i
human_rights_un_fin_jf_64kb_0034	
human_rights_un_fin_jf_64kb_0035	ɑrt̪iklɑ
human_rights_un_fin_jf_64kb_0036	jokɑisellɑ ihmisellæ on kɑikkiɑllɑ oikeus siihen et̪t̪æ hænet̪ henkilønæ t̪unnust̪et̪ɑɑn lɑin edessæ
human_rights_un_fin_jf_64kb_0037	
human_rights_un_fin_jf_64kb_0038	ɑrt̪iklɑ
human_rights_un_fin_jf_64kb_0039	kɑikki oʋɑt̪ t̪ɑsɑʋert̪ɑisiɑ lɑin edessæ jɑ oikeut̪et̪ut̪ erot̪ukset̪t̪ɑ yht̪ælæiseen lɑin suojɑɑn
human_rights_un_fin_jf_64kb_0040	kɑikillɑ on oikeus t̪ɑsɑʋert̪ɑiseen suojɑɑn t̪æt̪æ julist̪ust̪ɑ loukkɑɑʋɑɑ syrjint̪ææ ʋɑst̪ɑɑn sekæ kɑikkeɑ sellɑiseen syrjint̪ææn t̪æht̪ææʋææ yllyt̪yst̪æ ʋɑst̪ɑɑn
human_rights_un_fin_jf_64kb_0041	
human_rights_un_fin_jf_64kb_0042	ɑrt̪iklɑ
human_rights_un_fin_jf_64kb_0043	jokɑisellɑ on oikeus t̪ehokkɑɑseen hyʋit̪ykseen ɑsiɑnomɑisessɑ kɑnsɑllisessɑ t̪uomioist̪uimessɑ hæneen kohdist̪uneist̪ɑ t̪eoist̪ɑ jot̪kɑ loukkɑɑʋɑt̪ hænelle ʋɑlt̪iosæænnøllæ t̪ɑi lɑillɑ t̪urʋɑt̪t̪ujɑ perusoikeuksiɑ
human_rights_un_fin_jf_64kb_0044	
human_rights_un_fin_jf_64kb_0045	ɑrt̪iklɑ
human_rights_un_fin_jf_64kb_0046	ket̪ææn ei sɑɑ mieliʋɑlt̪ɑisest̪i pidæt̪t̪ææ ʋɑŋit̪ɑ t̪ɑi ɑjɑɑ mɑɑnpɑkoon
human_rights_un_fin_jf_64kb_0047	
human_rights_un_fin_jf_64kb_0048	ɑrt̪iklɑ
human_rights_un_fin_jf_64kb_0049	jokɑisellɑ on t̪æysin t̪ɑsɑɑrʋoisest̪i oikeus siihen et̪t̪æ hænt̪æ oikeudenmukɑisest̪i jɑ julkisest̪i kuullɑɑn riippumɑt̪t̪omɑssɑ jɑ puolueet̪t̪omɑssɑ t̪uomioist̪uimessɑ hænen oikeuksiɑɑn jɑ ʋelʋollisuuksiɑɑn mææræt̪t̪æessæ t̪ɑi hænt̪æ ʋɑst̪ɑɑn nost̪et̪t̪uɑ rikossyyt̪et̪t̪æ selʋit̪et̪t̪æessæ
human_rights_un_fin_jf_64kb_0050	
human_rights_un_fin_jf_64kb_0051	ɑrt̪iklɑ
human_rights_un_fin_jf_64kb_0052	jokɑisen rikollisest̪ɑ t̪eost̪ɑ syyt̪t̪eessæ oleʋɑn henkiløn edellyt̪et̪ææn oleʋɑn syyt̪øn siihen ɑst̪i kunnes hænen syyllisyyt̪ensæ on lɑillisest̪i t̪odist̪et̪t̪u julkisessɑ oikeudenkæynnissæ jossɑ hænelle t̪urʋɑt̪ɑɑn kɑikki hænen puolust̪ust̪ɑɑn ʋɑrt̪en t̪ɑrpeelliset̪ t̪ɑkeet̪
human_rights_un_fin_jf_64kb_0053	ket̪ææn ei pidæ t̪uomit̪ɑ rɑŋɑist̪ɑʋɑksi t̪eoist̪ɑ t̪ɑi lɑiminlyønneist̪æ jot̪kɑ eiʋæt̪ kɑnsɑllisen t̪ɑi kɑnsɑinʋælisen oikeuden mukɑɑn olleet̪ rikollisiɑ t̪ekohet̪kellæ
human_rights_un_fin_jf_64kb_0054	myøskææn ei pidæ t̪uomit̪ɑ ɑnkɑrɑmpɑɑn rɑŋɑist̪ukseen kuin mikæ oli soʋellet̪t̪ɑʋissɑ rɑŋɑist̪ɑʋɑn t̪eon suorit̪uʃet̪kellæ
human_rights_un_fin_jf_64kb_0055	
human_rights_un_fin_jf_64kb_0056	ɑrt̪iklɑ
human_rights_un_fin_jf_64kb_0057	ælkøøn mieliʋɑlt̪ɑisest̪i puut̪ut̪t̪ɑko kenenkææn yksit̪yiselæmææn perheeseen kot̪iin t̪ɑi kirjeenʋɑiht̪oon ælkøønkæ loukɑt̪t̪ɑko kenenkææn kunniɑɑ jɑ mɑinet̪t̪ɑ
human_rights_un_fin_jf_64kb_0058	jokɑisellɑ on oikeus lɑin suojɑɑn sellɑist̪ɑ puut̪t̪umist̪ɑ t̪ɑi loukkɑust̪ɑ ʋɑst̪ɑɑn
human_rights_un_fin_jf_64kb_0059	
human_rights_un_fin_jf_64kb_0060	ɑrt̪iklɑ
human_rights_un_fin_jf_64kb_0061	jokɑisellɑ on oikeus liikkuɑ ʋɑpɑɑst̪i jɑ ʋɑlit̪ɑ ɑsuinpɑikkɑnsɑ kunkin ʋɑlt̪ion sisællæ
human_rights_un_fin_jf_64kb_0062	jokɑisellɑ on oikeus læht̪eæ mɑɑst̪ɑ myøs omɑst̪ɑ mɑɑst̪ɑɑn jɑ pɑlɑt̪ɑ mɑɑhɑnsɑ
human_rights_un_fin_jf_64kb_0063	
human_rights_un_fin_jf_64kb_0064	ɑrt̪iklɑ
human_rights_un_fin_jf_64kb_0065	jokɑisellɑ ʋɑinon koht̪eeksi jout̪uneellɑ on oikeus hɑkeɑ jɑ nɑut̪t̪iɑ t̪urʋɑpɑikkɑɑ muissɑ mɑissɑ
human_rights_un_fin_jf_64kb_0066	t̪æhæn oikeut̪een ei ʋoidɑ ʋedot̪ɑ kun on kysymys t̪osi epæpoliit̪t̪isist̪ɑ rikoksist̪ɑ joht̪uʋist̪ɑ syyt̪t̪eist̪æ t̪ɑi t̪eoist̪ɑ jot̪kɑ oʋɑt̪ ʋɑst̪oin yhdist̪yneiden kɑnsɑkunt̪ien periɑɑt̪t̪eit̪ɑ jɑ pææmææriæ
human_rights_un_fin_jf_64kb_0067	
human_rights_un_fin_jf_64kb_0068	ɑrt̪iklɑ
human_rights_un_fin_jf_64kb_0069	jokɑisellɑ on oikeus kɑnsɑlɑisuut̪een
human_rights_un_fin_jf_64kb_0070	kelt̪ææn ei sɑɑ mieliʋɑlt̪ɑisest̪i riist̪ææ kɑnsɑlɑisuut̪t̪ɑ eikæ eʋæt̪æ oikeut̪t̪ɑ kɑnsɑlɑisuuden ʋɑiht̪ɑmiseen
human_rights_un_fin_jf_64kb_0071	
human_rights_un_fin_jf_64kb_0072	ɑrt̪iklɑ
human_rights_un_fin_jf_64kb_0073	t̪æysiikæisillæ miehillæ jɑ nɑisillɑ on oikeus solmiɑ ɑʋioliit̪t̪o jɑ perust̪ɑɑ perhe ilmɑn minkæænlɑisiɑ rodust̪ɑ kɑnsɑlɑisuudest̪ɑ t̪ɑi uskonnost̪ɑ joht̪uʋiɑ rɑjoit̪uksiɑ
human_rights_un_fin_jf_64kb_0074	heillæ on yht̪ælæiset̪ oikeudet̪ ɑʋioliit̪t̪oon ɑʋioliit̪on ɑikɑnɑ jɑ sen purkɑmisen jælkeen
human_rights_un_fin_jf_64kb_0075	ɑʋioliit̪on solmiminen t̪ɑpɑht̪ukoon ʋɑin t̪uleʋien ɑʋiopuolisoiden ʋɑpɑɑst̪ɑ jɑ t̪æydest̪æ suost̪umuksest̪ɑ
human_rights_un_fin_jf_64kb_0076	perhe on yht̪eiskunnɑn luonnollinen jɑ perust̪ɑʋɑ ydinosɑ jɑ sillæ on oikeus yht̪eiskunnɑn jɑ ʋɑlt̪ion suojɑɑn
human_rights_un_fin_jf_64kb_0077	
human_rights_un_fin_jf_64kb_0078	ɑrt̪iklɑ
human_rights_un_fin_jf_64kb_0079	jokɑisellɑ on oikeus omist̪ɑɑ omɑisuut̪t̪ɑ yksin t̪ɑi yhdessæ t̪oist̪en kɑnssɑ
human_rights_un_fin_jf_64kb_0080	kelt̪ææn ælkøøn mieliʋɑlt̪ɑisest̪i riist̪et̪t̪ækø hænen omɑisuut̪t̪ɑɑn
human_rights_un_fin_jf_64kb_0081	
human_rights_un_fin_jf_64kb_0082	ɑrt̪iklɑ
human_rights_un_fin_jf_64kb_0083	jokɑisellɑ ihmisellæ on ɑjɑt̪uksen omɑnt̪unnon jɑ uskonnon ʋɑpɑus
human_rights_un_fin_jf_64kb_0084	t̪æmæ oikeus sisælt̪ææ ʋɑpɑuden uskonnon t̪ɑi ʋɑkɑumuksen ʋɑiht̪ɑmiseen sekæ uskonnon t̪ɑi ʋɑkɑumuksen julist̪ɑmiseen yksin t̪ɑi yhdessæ t̪oist̪en kɑnssɑ sekæ julkisest̪i et̪t̪æ yksit̪yisest̪i opet̪t̪ɑmɑllɑ sekæ hɑrjoit̪t̪ɑmɑllɑ hɑrt̪ɑut̪t̪ɑ jɑ uskonnollisiɑ menojɑ
human_rights_un_fin_jf_64kb_0085	
human_rights_un_fin_jf_64kb_0086	ɑrt̪iklɑ
human_rights_un_fin_jf_64kb_0087	jokɑisellɑ on oikeus mielipit̪een jɑ sɑnɑnʋɑpɑut̪een
human_rights_un_fin_jf_64kb_0088	t̪æhæn sisælt̪yy oikeus hæirit̪semæt̪t̪æ pit̪ææ mielipit̪eensæ sekæ oikeus rɑjoist̪ɑ riippumɑt̪t̪ɑ hɑnkkiɑ ʋɑst̪ɑɑnot̪t̪ɑɑ jɑ leʋit̪t̪ææ t̪iet̪ojɑ kɑikkien t̪iedot̪usʋælineiden kɑut̪t̪ɑ
human_rights_un_fin_jf_64kb_0089	
human_rights_un_fin_jf_64kb_0090	ɑrt̪iklɑ
human_rights_un_fin_jf_64kb_0091	kɑikillɑ on oikeus rɑuhɑnomɑiseen kokoont̪umis jɑ yhdist̪ymisʋɑpɑut̪een
human_rights_un_fin_jf_64kb_0092	ket̪ææn ei sɑɑ pɑkot̪t̪ɑɑ liit̪t̪ymææn mihinkææn yhdist̪ykseen
human_rights_un_fin_jf_64kb_0093	
human_rights_un_fin_jf_64kb_0094	ɑrt̪iklɑ
human_rights_un_fin_jf_64kb_0095	jokɑisellɑ on oikeus osɑllist̪uɑ mɑɑnsɑ hɑllit̪semiseen joko ʋælit̪t̪ømæst̪i t̪ɑi ʋɑpɑɑst̪i ʋɑlit̪t̪ujen edust̪ɑjien ʋælit̪yksellæ
human_rights_un_fin_jf_64kb_0096	jokɑisellɑ on yht̪ælæinen oikeus pææst̪æ mɑɑnsɑ julkisiin t̪oimiin
human_rights_un_fin_jf_64kb_0097	kɑnsɑn t̪ɑht̪o on hɑllit̪usʋɑllɑn perust̪ɑ
human_rights_un_fin_jf_64kb_0098	t̪æmæ t̪ɑht̪o on ilmɑist̪ɑʋɑ mææræɑikɑisillɑ jɑ ɑidoillɑ ʋɑɑleillɑ joissɑ kɑikillɑ on yleinen jɑ yht̪ælæinen æænioikeus jɑ joissɑ æænest̪ys on sɑlɑinen t̪ɑi muut̪ɑ ʋɑɑliʋɑpɑuden t̪urʋɑɑʋɑɑ menet̪t̪elyæ noudɑt̪t̪ɑʋɑ
human_rights_un_fin_jf_64kb_0099	
human_rights_un_fin_jf_64kb_0100	ɑrt̪iklɑ
human_rights_un_fin_jf_64kb_0101	jokɑisellɑ on yht̪eiskunnɑn jæsenenæ oikeus sosiɑɑlit̪urʋɑɑn sekæ oikeus kɑnsɑllist̪en t̪oimenpit̪eiden jɑ kɑnsɑinʋælisen yht̪eist̪yøn kɑut̪t̪ɑ kunkin mɑɑn jærjest̪elmæ jɑ ʋoimɑʋɑrɑt̪ huomioonot̪t̪ɑen nɑut̪t̪iɑ hænen ihmisɑrʋolleen jɑ hænen yksiløllisen olemuksensɑ ʋɑpɑɑlle kehit̪t̪ymiselle ʋælt̪t̪æmæt̪t̪ømiæ t̪ɑloudellisiɑ sosiɑɑlisiɑ jɑ siʋist̪yksellisiæ oikeuksiɑ
human_rights_un_fin_jf_64kb_0102	
human_rights_un_fin_jf_64kb_0103	ɑrt̪iklɑ
human_rights_un_fin_jf_64kb_0104	jokɑisellɑ on oikeus t̪yøhøn t̪yøpɑikɑn ʋɑpɑɑseen ʋɑlint̪ɑɑn oikeudenmukɑisiin jɑ t̪yydyt̪t̪æʋiin t̪yøeht̪oihin sekæ suojɑɑn t̪yøt̪t̪ømyyt̪t̪æ ʋɑst̪ɑɑn
human_rights_un_fin_jf_64kb_0105	jokɑisellɑ on oikeus ilmɑn minkæænlɑist̪ɑ syrjint̪ææ sɑmɑɑn pɑlkkɑɑn sɑmɑst̪ɑ t̪yøst̪æ
human_rights_un_fin_jf_64kb_0106	jokɑisellɑ t̪yøt̪æ t̪ekeʋællæ on oikeus koht̪uulliseen jɑ riit̪t̪æʋææn pɑlkkɑɑn jokɑ t̪urʋɑɑ hænelle jɑ hænen perheelleen ihmisɑrʋon mukɑisen t̪oimeent̪ulon jɑ jot̪ɑ t̪ɑrpeen ʋɑɑt̪iessɑ t̪æydent̪æʋæt̪ muut̪ sosiɑɑlisen suojelun keinot̪
human_rights_un_fin_jf_64kb_0107	jokɑisellɑ on oikeus perust̪ɑɑ ɑmmɑt̪t̪iyhdist̪yksiæ jɑ liit̪t̪yæ niihin et̪ujensɑ puolust̪ɑmiseksi
human_rights_un_fin_jf_64kb_0108	
human_rights_un_fin_jf_64kb_0109	ɑrt̪iklɑ
human_rights_un_fin_jf_64kb_0110	jokɑisellɑ on oikeus lepoon jɑ ʋɑpɑɑɑikɑɑn t̪yøɑjɑn jærkeʋææn rɑjoit̪t̪ɑmiseen sekæ mææræɑikɑisiin pɑlkɑllisiin lomiin
human_rights_un_fin_jf_64kb_0111	
human_rights_un_fin_jf_64kb_0112	ɑrt̪iklɑ
human_rights_un_fin_jf_64kb_0113	jokɑisellɑ on oikeus elint̪ɑsoon jokɑ on riit̪t̪æʋæ t̪urʋɑɑmɑɑn hænen jɑ hænen perheensæ t̪erʋeyden jɑ hyʋinʋoinnin rɑʋinnon ʋɑɑt̪et̪uksen ɑsunnon læækint̪æhuollon jɑ ʋælt̪t̪æmæt̪t̪ømæn yht̪eiskunnɑllisen huollon osɑlt̪ɑ
human_rights_un_fin_jf_64kb_0114	jokɑisellɑ on myøs oikeus t̪urʋɑɑn t̪yøt̪t̪ømyyden sɑirɑuden t̪ɑpɑt̪urmɑn leskeyden t̪ɑi ʋɑnhuuden sekæ muun hænen t̪ɑhdost̪ɑɑn riippumɑt̪t̪ɑ t̪ɑpɑht̪uneen t̪oimeent̪ulon menet̪yksen ʋɑrɑlt̪ɑ
human_rights_un_fin_jf_64kb_0115	æideillæ jɑ lɑpsillɑ on oikeus erit̪yiseen huolt̪oon jɑ ɑpuun
human_rights_un_fin_jf_64kb_0116	kɑikkien lɑst̪en riippumɑt̪t̪ɑ siit̪æ oʋɑt̪ko he synt̪yneet̪ ɑʋioliit̪ossɑ t̪ɑi sen ulkopuolellɑ t̪ulee nɑut̪t̪iɑ sɑmɑɑ yht̪eiskunnɑn suojɑɑ
human_rights_un_fin_jf_64kb_0117	
human_rights_un_fin_jf_64kb_0118	ɑrt̪iklɑ
human_rights_un_fin_jf_64kb_0119	jokɑisellɑ on oikeus sɑɑdɑ opet̪ust̪ɑ
human_rights_un_fin_jf_64kb_0120	opet̪uksen on olt̪ɑʋɑ ɑinɑkin ɑlkeis jɑ perusopet̪uksen osɑlt̪ɑ mɑksut̪ont̪ɑ
human_rights_un_fin_jf_64kb_0121	ɑlkeisopet̪uksen on olt̪ɑʋɑ pɑkollinen
human_rights_un_fin_jf_64kb_0122	t̪eknist̪æ jɑ ɑmmɑt̪t̪iopet̪ust̪ɑ on olt̪ɑʋɑ yleisest̪i sɑɑt̪ɑʋillɑ jɑ korkeɑmmɑn opet̪uksen on olt̪ɑʋɑ ɑʋoinnɑ yht̪ælæisest̪i kɑikille heidæn kykyjensæ mukɑɑn
human_rights_un_fin_jf_64kb_0123	opet̪uksen on pyrit̪t̪æʋæ ihmisen persoonɑllisuuden t̪æyt̪een kehit̪t̪æmiseen sekæ ihmisoikeuksien jɑ perusʋɑpɑuksien kunnioit̪t̪ɑmisen ʋɑhʋist̪ɑmiseen
human_rights_un_fin_jf_64kb_0124	sen t̪ulee edist̪ææ ymmært̪æmyst̪æ suʋɑit̪seʋɑisuut̪t̪ɑ jɑ yst̪æʋyyt̪t̪æ kɑikkien kɑnsɑkunt̪ien jɑ kɑikkien rot̪u jɑ uskont̪oryhmien kesken sekæ pyrkiæ edist̪æmææn yhdist̪yneiden kɑnsɑkunt̪ien t̪oimint̪ɑɑ rɑuhɑn yllæpit̪æmiseksi
human_rights_un_fin_jf_64kb_0125	ʋɑnhemmillɑ on ensisijɑinen oikeus ʋɑlit̪ɑ heidæn lɑpsilleen ɑnnet̪t̪ɑʋɑn opet̪uksen lɑɑt̪u
human_rights_un_fin_jf_64kb_0126	
human_rights_un_fin_jf_64kb_0127	ɑrt̪iklɑ
human_rights_un_fin_jf_64kb_0128	jokɑisellɑ on oikeus ʋɑpɑɑst̪i osɑllist̪uɑ yht̪eiskunnɑn siʋist̪yselæmææn nɑut̪t̪iɑ t̪ɑit̪eist̪ɑ sekæ pææst̪æ osɑlliseksi t̪iet̪een edist̪yksen mukɑnɑɑn t̪uomist̪ɑ eduist̪ɑ
human_rights_un_fin_jf_64kb_0129	jokɑisellɑ on oikeus niiden henkist̪en jɑ ɑineellist̪en et̪ujen suojɑɑmiseen jot̪kɑ joht̪uʋɑt̪ hænen luomɑst̪ɑɑn t̪iet̪eellisest̪æ kirjɑllisest̪ɑ t̪ɑi t̪ɑit̪eellisest̪ɑ t̪uot̪ɑnnost̪ɑ
human_rights_un_fin_jf_64kb_0130	
human_rights_un_fin_jf_64kb_0131	ɑrt̪iklɑ
human_rights_un_fin_jf_64kb_0132	jokɑisellɑ on oikeus sellɑiseen yht̪eiskunnɑlliseen jɑ kɑnsɑinʋæliseen jærjest̪ykseen jonkɑ puit̪t̪eissɑ t̪æssæ julist̪uksessɑ esit̪et̪yt̪ oikeudet̪ jɑ ʋelʋollisuudet̪ ʋoiʋɑt̪ t̪æysin t̪ot̪eut̪uɑ
human_rights_un_fin_jf_64kb_0133	
human_rights_un_fin_jf_64kb_0134	ɑrt̪iklɑ
human_rights_un_fin_jf_64kb_0135	jokɑisellɑ ihmisellæ on ʋelʋollisuuksiɑ yht̪eiskunt̪ɑɑ koht̪ɑɑn koskɑ ʋɑin sen puit̪t̪eissɑ hænen yksiløllisen olemuksensɑ ʋɑpɑɑ jɑ t̪æysi kehit̪ys on mɑhdollinen
human_rights_un_fin_jf_64kb_0136	kæyt̪t̪æessææn oikeuksiɑɑn jɑ nɑut̪t̪iessɑɑn ʋɑpɑuksiɑɑn kukɑɑn ei ole muiden kuin sellɑist̪en lɑillɑ sæædet̪t̪yjen rɑjoit̪ust̪en ɑlɑinen joiden yksinomɑisenɑ t̪ɑrkoit̪uksenɑ on t̪urʋɑt̪ɑ t̪oist̪en oikeuksien jɑ ʋɑpɑuksien t̪unnust̪ɑminen jɑ kunnioit̪t̪ɑminen sekæ morɑɑlin julkisen jærjest̪yksen jɑ yleisen hyʋinʋoinnin oikeut̪et̪ut̪ ʋɑɑt̪imukset̪ kɑnsɑnʋɑlt̪ɑisessɑ yht̪eiskunnɑssɑ
human_rights_un_fin_jf_64kb_0137	næit̪æ oikeuksiɑ jɑ ʋɑpɑuksiɑ ei missææn t̪ɑpɑuksessɑ sɑɑ kæyt̪t̪ææ ʋɑst̪oin yhdist̪yneiden kɑnsɑkunt̪ien pææmææriæ jɑ periɑɑt̪t̪eit̪ɑ
human_rights_un_fin_jf_64kb_0138	
human_rights_un_fin_jf_64kb_0139	ɑrt̪iklɑ
human_rights_un_fin_jf_64kb_0140	mit̪ææn t̪æssæ julist̪uksessɑ ei sɑɑ t̪ulkit̪ɑ niin et̪t̪æ ʋɑlt̪io ryhmæ t̪ɑi yksit̪yinen henkilø ʋoi sen perust̪eellɑ kɑt̪soɑ oikeudekseen t̪ehdæ sellɑist̪ɑ mikæ ʋoisi hæʋit̪t̪ææ t̪æssæ mæærit̪elt̪yjæ oikeuksiɑ jɑ ʋɑpɑuksiɑ
