human_rights_un_nno_be_64kb_0001	
human_rights_un_nno_be_64kb_0002	
human_rights_un_nno_be_64kb_0003	ɔ dɛt ɔ ɡodkjənne dɛt nɑtuɾlæɡe mennæskeʋeɾdet mɛd like uɡ ʉmissɑndɛ ɾɛttɑɾ fɔɾ ɑllə mænnɛskæ pɔ jɔɾdɑ eɾ ɡɾunnlɑɡæt fɔɾ fɾidom ɾɛttfæɾd uɡ fɾæd ɪ ʋæɾdɑoɡ dɔ hɔn uɡ ʋøɾdsløʏsə mɔt mənneskæɾəttɑne hɑɾ føɾt tɪl bɑɾbɑɾiskɛ hɑndliŋɑɾ sɔm hɑɾ skɑkɑ sɑmʋitæt tɪl mɛnnɛskeɾəttɑ eɾ fɾɑmʋɔksteɾen ɪ dɛn ʋeɾdɑ dɛɾ mɛnnæskɑ skɑl hɑ tɑlefɾɪdum uɡ ʈusfɾɪdum uɡ ʋəɾɛ løʏste fɾɔ uttə uɡ næʉd kunŋjɔɾd sɔm dɛt høɡste mɔlet fɔɾ kʋɑɾt mænnæskəɔɡ dɔ dɛt eɾ nødʋɛndiɡ ɑt mənneskæɾəttɑne blɪɾ ʋeɾnɑ um ɑʋ lɔʋəɾ slɪk ɑt mɛnnæskɑ ikkje blɪɾ tʋɪŋɑ tɪl ɔ fɪnnɛ dɛn sɪstɛ utʋeɡæn ɪ ɔ ɡjeɾɛ uppɾøɾ mɔt tyɾɑnnɪ uɡ ʈælækɔɾuɡ dɔ dɛt eɾ nødʋɛndiɡ ɔ ɑɾbɛɪdæ fɔɾ bɛʈɛ tɪlhøʋe mɛllum nɑsjonɑnɛuɡ dɔ fɔlkɑ ɪ æɪ ɑmæɪntɛ ɑsjonɑnə hɑɾ stɑdfæst ʈuɑ sɪ ɪ dennæ pɑktɑ pɔ ɡɾunnləɡɡjɑndæ mənnɛskæɾɛttɑɾ pɔ mɛnnɛskəʋeɾd uɡ pɔ sɑmə ɾɛtt fɔɾ mɑnn uɡ kʋinnə uɡ hɑɾ ʋɛdtækæ ɔ ɑɾbɛɪdæ fɔɾ sosiɑlæ fɾɑmsteɡ uɡ bɛʈɛ læʋəʋɪlkɔɾ ɪ støɾɾe fɾɪdumɔɡ dɔ mɛdlæmsstɑtɑne hɑɾ bʉndɛ sɛɡ tɪl ɔ fɾemjə ɑllmɛnn ʋøɾdnɑd fɔɾ pɑktɑ uɡ hɑldɛ sɛɡ ettɛɾ mənneskæɾəttɑne uɡ dɛn ɡɾunnləɡɡjɑndæ fɾidumən ɪ sɑmɑɾbæɪd mɛd æɪ ɑmæɪntɛ ɑsjunɑnəuɡ dɔ dennæ ɾætten uɡ fɾidumən mɔ blɪ ɡɔdkjɛnd ɑʋ ɑllə dɛɾsum pɑktɑ skɑl blɪ ɾøʏndɔm
human_rights_un_nno_be_64kb_0004	
human_rights_un_nno_be_64kb_0005	
human_rights_un_nno_be_64kb_0006	sɔm skɑl pæɪkə mɔt æɪt sɑms mɔl fɔɾ ɑllə fulk uɡ nɑsjɔnɑɾ
human_rights_un_nno_be_64kb_0007	ɾɔseɡnɑ mɔ ɑlltɪd ʋəɾɛ ɪ tɑnkɑne tɪl dɛn ɛɪnskɪldɛ uɡ dɛɪ styɾɑndɛ uɡ fɔ dɛɪ tɪl ɔ styɾkje ʋøɾdnɑdən fɔɾ ɾɛtt uɡ fɾidom ɡjənnum ʉndæɾʋɪsniŋ uɡ ɔppsedɪŋ
human_rights_un_nno_be_64kb_0008	æɪ skɑl syte fɔɾ ɑt fɾɔsəɡnɑ blɪɾ ɑllmɛnt kjend uɡ ɛtteɾləʋd bɔdə ɪ mədlæmslɑndɑ uɡ ɪ tilsʏnsɔmɾɔdɑ uɡ ɑɾbɛɪdæ ʈʉfɑst mɛd dettæ bɔdə pɔ nɑsjɔnɑlt uɡ ɪntəɾnɑsjunɑlt ɡɾʉnnlɑɡ
human_rights_un_nno_be_64kb_0009	ɾtɪkkæl
human_rights_un_nno_be_64kb_0010	llɛ mænnɛskæ eɾ føddɛ tɪl fɾidom uɡ mɛd sɑmə mɛnnɛskəʋeɾd uɡ mənnɛskæɾɛttɑɾ
human_rights_un_nno_be_64kb_0011	æɪ hɑɾ fɔtt foɾnuft uɡ sɑmʋɪt uɡ skɑl ləʋɛ mɛd kʋɑɾɑnɖɛ sɔm bɾøɾ
human_rights_un_nno_be_64kb_0012	ɾtɪkkæl
human_rights_un_nno_be_64kb_0013	ʋɑɾ æɪnskɪld hɑɾ kɾɑʋ pɔ ɑll dɛn ɾɛtt uɡ fɾidom sɔm fɾɔsəɡnɑ næmneɾ ʉtɑn skilnɑd ɑʋ nɔko slɑɡ pɔ ɡɾunn ɑʋ ɾɑsə fɑɾɡɛ kjønn spɾɔk ɾælɪɡiun pɔlɪtisk sʏn ellɛɾ ɑnnɑ mæɪniŋ nɑsjɔnɑlt ellɛɾ sosiɑlt upphɑʋ ɛɪɡɛdom fødsæl ellɛɾ ɑnɖæ tɪlhøʋe
human_rights_un_nno_be_64kb_0014	en pulitɪskɛ stɔdɑ loʋʋæɾket ellɛɾ dɛɪ ɪnteɾnɑsjunɑlə pɔbɔdɑ æɪt lɑnd leʋeɾ ʉndeɾ kɑn ikkje ʋəɾɛ pɔskutt tɪl ɑt dɛt blɪɾ ɡjɔɾt skilnɑd pɔ nukɔn ɪ dɛt lɑndæt ellɛɾ ɔmɾɔdɛt hɑn høʏɾəɾ tɪl ɑnten lɑndæt hɑɾ sjølʋstændə stɔɾ ʉndeɾ tɪlsyn eɾ ikkjesjølʋstʏɾt ellɛɾ sjølʋstʏɾet eɾ ɑʋɡɾənsɑ pɔ nukɔn ɑnnɑn mɔtə
human_rights_un_nno_be_64kb_0015	ɾtɪkkæl
human_rights_un_nno_be_64kb_0016	llɛ hɑɾ ɾɛtt tɪl lɪʋ fɾidom uɡ peɾsunleɡ ʈyɡɡlɛɪk
human_rights_un_nno_be_64kb_0017	ɾtɪkkæl
human_rights_un_nno_be_64kb_0018	ŋɛn skɑl hɑldɑst ɪ slɑʋæɾi ellɛɾ ʈɛldom
human_rights_un_nno_be_64kb_0019	lɑʋæɾi uɡ slɑʋehɑndel ɑʋ ɑllə slɑɡ eɾ foɾbudɛ
human_rights_un_nno_be_64kb_0020	ɾtɪkkæl
human_rights_un_nno_be_64kb_0021	ŋɛn mɔ tuɾtʉɾəɾɑst pɪnɑst ellɛɾ sʈɑffɑst pɔ ʉmenneskɛlɛɡ ellɛɾ nɛdsetjɑndə ʋɪs
human_rights_un_nno_be_64kb_0022	ɾtɪkkæl
human_rights_un_nno_be_64kb_0023	llɛ mænnɛskæ hɑɾ kɾɑʋ pɔ ɑt dɔmstulɑnə ɑllə stɑdæɾ ɡodtek dɛɪ sɔm ɾættssubjəkt
human_rights_un_nno_be_64kb_0024	ɾtɪkkæl
human_rights_un_nno_be_64kb_0025	llɛ eɾ like fɔɾ luʋɑ uɡ hɑɾ kɾɑʋ pɔ sɑmə ɾɛttsʋæɾn ʉtɑn skilnɑd ɑʋ nɔko slɑɡ
human_rights_un_nno_be_64kb_0026	llɛ hɑɾ kɾɑʋ pɔ sɑmə ʋɛɾn mɔt ɑt dɛt blɪɾ ɡjɔɾt skilnɑd pɔ fulk ɪ sʈɪd mɛd dennæ fɾɔsəɡnɑ uɡ ʋɛɾn mɔt tɪltɑk sɔm bɛɾ ɪ sɛɡ æɪn slɪk fɑɾə
human_rights_un_nno_be_64kb_0027	ɾtɪkkæl
human_rights_un_nno_be_64kb_0028	llɛ hɑɾ ɾɛtt tɪl ɔ fɔ fullɡud hjelp fɾɔ dɛɪ lɔʋləɡe nɑsjɔnɑlɛ dɔmstulɑnə nɔɾ dɛt ɡjeld hɑndliŋɑɾ sɔm kɾænkjeɾ dɛn ɾætten dɛn ɛɪnskɪldɛ hɑɾ fɔtt ɪ ɡɾunnluʋɑ ellɛɾ loʋʋæɾket ellɛs
human_rights_un_nno_be_64kb_0029	ɾtɪkkæl
human_rights_un_nno_be_64kb_0030	ŋɑn mɔ ʉtɑn lɔʋ uɡ ɾɛtt ɑɾɾestæɾɑst sɛtjɑst ɪ fəŋsɛl ellɛɾ ʋɪsɑst ʉt uɾ lɑndæt
human_rights_un_nno_be_64kb_0031	ɾtɪkkæl
human_rights_un_nno_be_64kb_0032	llɛ hɑɾ sɑmə ɾɛtt tɪl ɔ fɔ sɑkɑ sɪ ɾættfeɾdiɡ uɡ ɔffɛntlæɡ ɡɾɑnskɑ ɑʋ æɪn sjølʋstɛndiɡ uɡ ʉpɑɾtɪsk dɔmstɔl bɔdə nɔɾ dɛt eɾ pliktənæ uɡ ɾætten tɪl dɛn ɛɪnskɪldɛ sɔm skɑl fɑstsætjɑst uɡ nɔɾ dɛt eɾ ɾæɪst klɑɡəmɔl mɔt hɑn
human_rights_un_nno_be_64kb_0033	ɾtɪkkæl
human_rights_un_nno_be_64kb_0034	en sɔm eɾ klɑɡɑ fɔɾ æɪ sʈɑffbɑɾ hɑndlɪŋ hɑɾ ɾɛtt tɪl ɔ blɪ ɾeknɑ sɔm skuldlæʉs tɪl æɪn ɔffɛntlæɡ dɔmstɔl dɛɾ hɑn hɑɾ fɔtt fʉll ʈʏɡd fɔɾ ɾætten tɪl ɔ foɾsʋɑɾɛ sɛɡ hɑɾ pɾɔʋɑ ɑt hɑn eɾ skʉldiɡ ettɛɾ luʋɑ
human_rights_un_nno_be_64kb_0035	ŋɛn skɑl kjænnɑst skʉldiɡ ɪ æɪ sʈɑffbɑɾ hɑndlɪŋ nɔɾ dɛt hɑn hɑɾ ɡjɔɾt ellɛɾ fuɾsømt ikkje sʈɛɪd mɔt nɑsjɔnɑl lɔʋ ellɛɾ folkəɾætten pɔ dɛn tɪdɑ dɛt hendæ
human_rights_un_nno_be_64kb_0036	ɑn mɔ hælleɾ ikkje dømɑst hɑɾdɑɾe enn dɛt luʋɑ ɡɑʋ høʋə tɪl dɔ dɛn sʈɑffbɑɾæ hɑndliŋɑ ʋɑɾt ʉtføɾd
human_rights_un_nno_be_64kb_0037	ɾtɪkkæl
human_rights_un_nno_be_64kb_0038	ŋɛn skɑl lide ʉndeɾ ʋɪlkɔɾləɡ ɪnnblɑndɪŋ fɾɔ ɑnɖæ ɑnten dɛt ɡjeld hɑns ɛɪɡən pɛɾsun fɑmilɪæ hæɪm bɾəʋskiftɛ ellɛɾ ɔtɑk pɔ ɛɾæ uɡ umdøme
human_rights_un_nno_be_64kb_0039	llɛ hɑɾ kɾɑʋ pɔ ɑt luʋɑ ʋɛɾnɑɾ dɛɪ mɔt slɪk ɪnnblɑndɪŋ ellɛɾ slikɛ ɔtɑk
human_rights_un_nno_be_64kb_0040	ɾtɪkkæl
human_rights_un_nno_be_64kb_0041	llɛ mænnɛskæ hɑɾ ɾɛtt tɪl ɔ fɛɾdɑst fɾitt uɡ tɪl ɔ ʋeljæ bʉstɑd innɑfuɾ ɡɾensənɛ ɪ sɪtt æɪɡə lɑnd
human_rights_un_nno_be_64kb_0042	et skɑl uɡsɔ ʋəɾɛ fʉll ɾɛtt tɪl ɔ ɾæɪsə ʉt uɾ dɛt lɑndæt æɪn bʉɾ ɪ sɑmə kʋɑ lɑnd dɛt eɾ uɡ tɪl ɔ ʋendæ ɑttɛndɛ tɪl sɪtt æɪɡə lɑnd
human_rights_un_nno_be_64kb_0043	ɾtɪkkæl
human_rights_un_nno_be_64kb_0044	llɛ sɔm blɪɾ fuɾfølɡdə hɑɾ ɾɛtt tɪl ɔ søkjɛ uɡ tɑ imut ɑsʏl ɪ æɪt ɑnnɑ lɑnd
human_rights_un_nno_be_64kb_0045	ænne ɾætten ɡjeld ikkje ɪ ɾəttssɑkɑɾ sɔm hɑɾ ɾøʏnlæɡ ɡɾʉnnlɑɡ ɪ upolɪtiskæ bɾotsʋɛɾk ellɛɾ hɑndliŋɑɾ sɔm sʈɪɾ mɔt fuɾmɔlet uɡ pɾinsɪppɛt tɪl æɪ ɑmæɪntɛ ɑsjonɑnə
human_rights_un_nno_be_64kb_0046	ɾtɪkkæl
human_rights_un_nno_be_64kb_0047	llɛ hɑɾ ɾɛtt tɪl æɪt stɑtsbɔɾɡɑɾskɑp
human_rights_un_nno_be_64kb_0048	ŋɛn skɑl mɪssɛ stɑtsbuɾɡɑɾskɑpæt sɪtt ʋɪlkɔɾləɡ ellɛɾ blɪ nektɑ ɾætten tɪl ɔ ɛnɖe dɛt
human_rights_un_nno_be_64kb_0049	ɾtɪkkæl
human_rights_un_nno_be_64kb_0050	ɑksnɛ mɛnn uɡ kʋɪnnæɾ hɑɾ ɾɛtt tɪl ɔ ɡɪftɛ sɛɡ uɡ skipɛ fɑmilɪæ ʉtɑn ɑʋɡɾənsiŋ ɑʋ nɔko slɑɡ pɔ ɡɾunn ɑʋ ɾɑsə nɑsjɔnɑlɪtɛt ellɛɾ ɾælɪɡiun
human_rights_un_nno_be_64kb_0051	æɪ hɑɾ kɾɑʋ pɔ dɛɪ sɑmə ɾættɑnæ nɔɾ dɛt ɡjeld ektæskɑpet bɔdə sɔ lɛŋɛ ektæskɑpet ʋɑɾeɾ uɡ medɑn dɛt blɪɾ løʏst ɔpp
human_rights_un_nno_be_64kb_0052	ktæskɑpet mɔ beɾɾæ kɔmæ ɪ stɑnd ettɛɾ fɾitt uɡ fullt sɑmtykkɛ fɾɔ beɡɡæ pɑɾtɑɾ
human_rights_un_nno_be_64kb_0053	ɑmɪlɪæn eɾ dɛn nɑtuɾlæɡe uɡ ɡɾunnləɡɡjɑndæ æɪniŋɑ ɪ sɑmfʉnnɛt uɡ hɑɾ kɾɑʋ pɔ ɑt stɑtæn uɡ sɑmfʉnnɛt ʋɛɾnɑɾ um dɛt
human_rights_un_nno_be_64kb_0054	ɾtɪkkæl
human_rights_un_nno_be_64kb_0055	llɛ hɑɾ ɾɛtt tɪl ɔ hɑ ɛɪɡɛdom ɔlɛɪne uɡ sɑmɑn mɛd ɑnɖæ
human_rights_un_nno_be_64kb_0056	ŋɛn skɑl ʋɪlkɔɾləɡ blɪ fɾɔtɛkən æɪɡedumæn sɪn
human_rights_un_nno_be_64kb_0057	ɾtɪkkæl
human_rights_un_nno_be_64kb_0058	llɛ hɑɾ ɾɛtt tɪl tɑnkəfɾidɔm sɑmʋitsfɾidɔm uɡ ɾælɪɡɪɔnfɾɪdum
human_rights_un_nno_be_64kb_0059	ænne ɾætten ɡjeld fɾidom tɪl ɔ ɛnɖe ɾælɪɡiun ellɛɾ ʈʉ uɡ fɾidom tɪl ɔ mɔlbəɾɛ sɪn ɛɪɡən ɾælɪɡiun ellɛɾ sɪ æɪɡɑ ʈʉslæɾə ɪ ɡjɛɾnɪŋ uɡ fɾɑmfæɾd ɑnten ɔlɛɪne ellɛɾ sɑmɑn mɛd ɑnɖæ ɔffɛntlæɡ ellɛɾ pɾɪʋɑt
human_rights_un_nno_be_64kb_0060	ɾtɪkkæl
human_rights_un_nno_be_64kb_0061	llɛ skɑl hɑ mæɪnɪŋs uɡ ʏʈiŋsfɾɪdum
human_rights_un_nno_be_64kb_0062	ænne ɾætten ɡjeld fɾidom tɪl ɔ hɑ mæɪniŋɑɾ ʉtɑn ɪnnblɑndɪŋ tɪl ɔ søkjɛ tɑ imut uɡ ɡjeɾɛ kjent ɔpplʏsniŋɑɾ uɡ ɪdeɑɾ ɡjənnum ɑllə dɛɪ ɪnfoɾmɑsjɔnskɑnɑlɑɾ sɔm finst uɡ pɔ tʋeɾs ɑʋ ɑllə ɡɾɛnsɛɾ
human_rights_un_nno_be_64kb_0063	ɾtɪkkæl
human_rights_un_nno_be_64kb_0064	llɛ hɑɾ ɾɛtt tɪl fɾitt ɔ ʋəɾɛ mɛd pɔ møtə uɡ ɪ uɾɡɑnɪsɑsjonɑɾ mɛd fɾədeleɡæ fuɾmɔl
human_rights_un_nno_be_64kb_0065	ŋɛn kɑn tʋɪŋɑst inn ɪ æɪn uɾɡɑnisɑsjun
human_rights_un_nno_be_64kb_0066	ɾtɪkkæl
human_rights_un_nno_be_64kb_0067	llɛ skɑl hɑ ɾɛtt tɪl ɔ ʋəɾɛ mɛd pɔ ɔ styɾɛ lɑndæt sɪtt bæɪnʋæɡəs ellɛɾ ɡjənnum tɑlsmænn sɔm eɾ pæɪkɑ ʉt ɪ fɾiə ʋɑl
human_rights_un_nno_be_64kb_0068	llɛ skɑl hɑ sɑmə ɾætten tɪl ɔ ɡjeɾɛ tenɛstæ ɪ uffəntləɡɛ ɔmbod ɪ lɑndæt sɪtt
human_rights_un_nno_be_64kb_0069	ɔlkɛʋɪljən skɑl ʋəɾɛ ɡɾunnlɑɡæt fɔɾ dɛn mɑktɑ sɔm eɾ lɑɡd tɪl stʏɾɛmɑktənæ
human_rights_un_nno_be_64kb_0070	ɔlkɛʋɪljən skɑl kɔmæ tɪl syne ɡjənnum ɾəɡelfɑstə uɡ ɾøʏnlæɡɛ ʋɑl sɔm eɾ ɡɾʉnnɑ pɔ ɑllmɛnn uɡ lɪk ɾøʏsteɾɛtt ɪ løʏnlæɡɛ ʋɑl ellɛɾ pɔ ɑnnɑn jɑmɡɔd ɾøʏstemɔtæ
human_rights_un_nno_be_64kb_0071	ɾtɪkkæl
human_rights_un_nno_be_64kb_0072	ʋɑɾ æɪnskɪld mædlem ɪ sɑmfʉnnɛt hɑɾ ɾɛtt tɪl sɔsɪɑl ʈyɡɡlɛɪk uɡ hɑɾ kɾɑʋ pɔ ɑt dɛɪ økɔnomɪske sosiɑlæ uɡ kultuɾəllə ɡodɑnə sɔm hɑn ikkje kɑn ʋəɾɛ ʉtɑn um hɑn skɑl hɑ ʋøɾdnɑd fɔɾ sɛɡ sjølʋ uɡ styɾkə dɛn pæɾsɔnleɡɛ kɑɾɑktəɾæn sɪn blɪɾ løʏste ɡjənnum nɑsjɔnɑlɛ tɪltɑk uɡ ɪntəɾnɑsjunɑlt sɑmɑɾbæɪd ɪ sɑmsʋɑɾ mɛd dɛt kʋɑɾ stɑt mɑktɑɾ
human_rights_un_nno_be_64kb_0073	ɾtɪkkæl
human_rights_un_nno_be_64kb_0074	llɛ hɑɾ ɾɛtt tɪl ɑɾbæɪd tɪl fɾitt ɔ ʋeljæ yɾkɛ tɪl ɾættfəɾdɪɡe uɡ ɡɔdæ ɑɾbæɪdstɪlhøʋæ uɡ ʋɛɾn mɔt ɑɾbæɪdsløʏse
human_rights_un_nno_be_64kb_0075	llɛ hɑɾ sɑmə ɾɛtt tɪl ɔ fɔ lɪk betɑliŋ fɔɾ lɪkt ɑɾbæɪd ʉtɑn skilnɑd ɑʋ nɔko slɑɡ
human_rights_un_nno_be_64kb_0076	en sɔm ɑɾbæɪdeɾ hɑɾ kɾɑʋ pɔ ɾættfeɾdiɡ uɡ ɡɔd betɑliŋ sɔ hɑn kɑn syte fɔɾ fɑmɪliɛn sɪn uɡ sɛɡ sjølʋ pɔ æɪn mənnæskæʋəɾdiɡ mɔtə uɡ um dɛt ʈɛŋst fɔ hjelp ɡjənnum ɑnɖæ uɡ ʉtfyllɑndɛ sosiɑlæ mɪdlɑɾ
human_rights_un_nno_be_64kb_0077	llɛ hɑɾ ɾɛtt tɪl ɔ skipɛ uɡ meldæ sɛɡ inn ɪ fɑɡfoɾenɪŋɑɾ fɔɾ ɔ ʋeɾnæ intɛɾəssenæ sine
human_rights_un_nno_be_64kb_0078	ɾtɪkkæl
human_rights_un_nno_be_64kb_0079	llɛ hɑɾ ɾɛtt tɪl kʋilɛ uɡ fɾɪtid uɡ dæɾmed tɪl æɪ ɾimælɛɡ ɑʋɡɾənsɑ ɑɾbɛɪdstid uɡ tɪl fɛɾɪe mɛd løn
human_rights_un_nno_be_64kb_0080	ɾtɪkkæl
human_rights_un_nno_be_64kb_0081	llɛ hɑɾ ɾɛtt tɪl æɪn leʋəstɑndɑɾd sɔm kɑn ʈʏɡɡje helsɑ uɡ ʋəlʋɛɾet tɪl fɔɾsʏtɑɾən uɡ fɑmɪliɛn hɑns uɡ ɡjɛ dɛɪ mɑt kledɛ hʉs həlsəstəll uɡ nødʋɛndiɡə sosiɑlæ ʈʏɡdɛɾ ʋɛd ɑɾbæɪdsløʏse uføɾe dødsfɑll ɑldəɾdum ellɛɾ ɑnɖæ tɪlhøʋe sɔm skiplɑɾ lɪʋskɔɾɑ uɡ sɔm fɔɾsʏtɑɾən ikkje eɾ heɾɾæ uʋæɾ
human_rights_un_nno_be_64kb_0082	uɾ uɡ bɑɾn hɑɾ ɾɛtt tɪl sæɾskild omsɔɾɡ uɡ hjelp
human_rights_un_nno_be_64kb_0083	llɛ bɑɾn skɑl hɑ sɑmə sosiɑlæ ʋɛɾn ɑnten dɛɪ eɾ føddɛ ɪ ellɛɾ utɑfuɾ ektæskɑpet
human_rights_un_nno_be_64kb_0084	ɾtɪkkæl
human_rights_un_nno_be_64kb_0085	llɛ hɑɾ ɾɛtt tɪl ʉndæɾʋɪsniŋ
human_rights_un_nno_be_64kb_0086	pplɛɾiŋɑ skɑl ʋəɾɛ kustnɑdsfɾi ɪ dɛt minste ɪ dɛn ɑllmɛnnə ɡɾʉnnskulæn
human_rights_un_nno_be_64kb_0087	en elæmæntæɾɛ ʉndɛɾʋisniŋɑ skɑl ʋəɾɛ plɪktiɡ fɔɾ ɑllə
human_rights_un_nno_be_64kb_0088	llɛ skɑl hɑ høʋə tɪl ɔ fɔ fɑɡupplɛɾɪŋ uɡ dɛt skɑl ʋəɾɛ like ʋɪlkɔɾ fɔɾ ɑllə tɪl ɔ fɔ høɡɾɛ utdɑnɪŋ ɑlt ettɛɾ dɛɪ æʋnenæ dɛɪ hɑɾ
human_rights_un_nno_be_64kb_0089	ndæɾʋisniŋɑ skɑl hɑ tɪl mɔl ɔ styɾkje dɛn mɛnnɛskɛlæɡæ pəɾsonlæɡdumɛn uɡ æʉkæ ʋøɾdnɑdən fɔɾ mənneskæɾəttɑne uɡ dɛn ɡɾunnləɡɡjɑndæ fɾidumən fɾemjə skjønsemd tɔləɾɑnsɛ uɡ ʋɛnskɑp mɛllum ɑllə nɑsjɔnɑɾ fɔlkɛslɑɡ uɡ ɾəlɪɡɪøsɛ ɡɾʉppæɾ uɡ stø fɾedsɑɾbæɪdɛt tɪl æɪ ɑmæɪntɛ ɑsjonɑnə
human_rights_un_nno_be_64kb_0090	oɾəlɖɑ hɑɾ føɾstɛɾetten tɪl ɔ ʋeljæ kʋɑ slɑɡ ɔpplɛɾiŋ bɑɾnɑ dæɪɾɑ skɑl fɔ
human_rights_un_nno_be_64kb_0091	ɾtɪkkæl
human_rights_un_nno_be_64kb_0092	llɛ hɑɾ ɾɛtt tɪl fɾitt ɔ ʋəɾɛ mɛd ɪ dɛt kultuɾəllə lɪʋet ɪ sɑmfʉnnɛt tɪl ɔ nyte kunst uɡ tɪl ɔ fɔ sɪn pɑɾt ɑʋ dɛɪ ʋɪtskɑpleɡə nyʋɪnnɪŋɑnæ uɡ ɡodɑnə sɔm følɡjæɾ mɛd dɛɪ
human_rights_un_nno_be_64kb_0093	ʋɑɾ æɪnskɪld hɑɾ ɾɛtt tɪl ɔ fɔ ʋeɾnɑ dɛɪ moɾɑlskɛ uɡ mɑtəɾɪəllæ intɛɾəssenæ sɔm hɑn hɑɾ skɑpt sɛɡ ɡjənnum ʋɪtskɑpləɡ littɛɾɛɾt ellɛɾ kunstnɑɾleɡ ɑɾbæɪd
human_rights_un_nno_be_64kb_0094	ɾtɪkkæl
human_rights_un_nno_be_64kb_0095	llɛ hɑɾ kɾɑʋ pɔ ɔ fɔ ləʋɛ ʉndeɾ slikɛ sosiɑlæ kɔɾ uɡ ɪnteɾnɑsjunɑlə tɪlhøʋe ɑt dɛɪ fullt ʉt kɑn ɡjeɾɛ tɪl ɾøʏndɔm ɾætten uɡ fɾidumən ɪ dennæ fɾɔsəɡnɑ
human_rights_un_nno_be_64kb_0096	ɾtɪkkæl
human_rights_un_nno_be_64kb_0097	llɛ hɑɾ plɪktæɾ ɑndsynæs sɑmfʉnnɛt dɔ pəɾsonlæɡdumɛn tɪl dɛn ɛɪnskɪldɛ æɪnɑst dɛɾ kɑn fɔ fɾiə uɡ fullɡɔdɛ ʋɔkstɛɾkɔɾ
human_rights_un_nno_be_64kb_0098	ettɛn uɡ fɾidumən tɪl dɛn ɛɪnskɪldɛ skɑl ikkje ʋəɾɛ ɑʋɡɾənsɑ ɑʋ ɑnnɑ enn dɛt luʋɑ tydælɛɡ slɔɾ fɑst fɔɾ ɔ ʈʏɡɡje dɛn ʋøɾdnɑdən ɑllə ɑnɖæ hɑɾ kɾɑʋ pɔ nɔɾ dɛt ɡjeld ɾɛtt uɡ fɾidom uɡ dɛɪ kɾɑʋ sɔm æɪt dəmukɾɑtɪsk sɑmfunn mɛd ɾettæ kɑn setjæ tɪl mɔɾɑl ɔffɛntlæɡ oɾden uɡ ɑllmɛnn ʋɛlfɛɾd
human_rights_un_nno_be_64kb_0099	ænne ɾætten uɡ fɾidumən kɑn ikkje ɪ nɔko høʋə nʏttɑst ɪ sʈɪd mɛd fuɾmɔlet uɡ pɾinsɪppɛt tɪl æɪ ɑmæɪntɛ ɑsjonɑnə
human_rights_un_nno_be_64kb_0100	ɾtɪkkæl
human_rights_un_nno_be_64kb_0101	kkjə nɔko ɪ dennæ fɾɔsəɡnɑ mɔ tulkɑst slɪk ɑt dɛt ɡjæʋ stɑt ɡɾʉppæɾ ellɛɾ ɛɪnskildmənneskæ ɾɛtt tɪl ɔ ʋəɾɛ mɛd pɔ tɪltɑk ellɛɾ hɑndliŋɑɾ ɑʋ nɔko slɑɡ sɔm hɑɾ tɪl mɔl ɔ øʏdəleɡɡjɛ dɛn ɾætten uɡ fɾidumən sɔm dennæ fɾɔsəɡnɑ stɑdfæstəɾ
