human_rights_un_ace_adam_64kb_0001	ssalammoəlaikum məunan olon xɛon wəte beɛ səlɪʊm meurumpɔk ɡəta wə alaikum səlam balaih ɡəta xɛon ɡɪʊtaɲɔɛ tasɛoɲom rʊməh ləɡʊina lɔn pophʊn ladʒʊə məukɛʊsʊd olon kəonɔe olon trɔn meurumpɔk ɡəta lɔn pəotrok həba soai pəlɪŋ phɔn eʊɲətəan mum əkək sasɪ ənʊsea
human_rights_un_ace_adam_64kb_0002	iɪp orəoŋ lahɪə dəŋʊn haxək drʊʊ karɛʊna ɡəutaɲʊ bəŋsa mənʊsɪə haxək mʊteulak ɲəŋ səban kəo bərəŋsʊ dʒih lɔn ŋon ɡəta drɔɛ səma mulɪa ɛʊʃərɪkatən əŋsaəŋsə kəna komɪtmɛn məunan kəoh dexɛon leə əwək loa didʒundʒʊŋ disɛoɔn dilindʊŋ depəʊthɛʊn pɪʊɲulʊh orəoŋ hərʊik merdɛka
human_rights_un_ace_adam_64kb_0003	əne komɪtmɛn bək awai phɔn pʊtəh lɪtʃən lɔn nɪolʊp sɪonɔn ɪaɡam ɛʊʃərɪkatən əŋsaəŋsə di senan dexɛon keujakinən ɡɪʊtaɲɔɛ bandum kəo ɲən hai adun ək sasɪ ənʊsea
human_rights_un_ace_adam_64kb_0004	əmpalə kʊneŋ dʒipʊoɪ uɪ barɔh tʃɪtʃəm tʃəudaih dʒrɔh tʃeʊŋklək ləɡʊina urʊʊe kə beʊŋʊh dʒandʒɪ kə putoih mət bək kukoih ək sasɪ ənʊsea
human_rights_un_ace_adam_64kb_0005	
human_rights_un_ace_adam_64kb_0006	ukədimah
human_rights_un_ace_adam_64kb_0007	ə beləʊŋbiləoŋ ranub ləm poan hən tɔk dəʊlapən di dəlam rəɡa tə temaŋtimaŋ eʊɲətəan mum ɲən nə tʊdʒʊh biləŋan pəlɪŋ otamə
human_rights_un_ace_adam_64kb_0008	eʊsɛobɔt bək phɔn mərtəbat ələmiəh hək ɲəŋ pantaih məxəulok mənʊsɪə haxək ɲəŋ səban dən mʊteulak səh teompat təumɛʊdʊk kɛmɛrdɪkaən kəədelan pərdamaian dunɪa
human_rights_un_ace_adam_64kb_0009	ʊai kɪdoa ɲəŋ detɪmaŋteməŋ depandaŋ həna jum orəoŋ abɛɪhna ləo that boɛt əwək ɲən laɡɪə bɪnataŋ beuŋɪh meoradaŋ hatɪə mənʊsɪə
human_rights_un_ace_adam_64kb_0010	əsə tɪuməkʊt teɛp urʊʊe sabɪə odəp ŋon matɪə həna ləo beda hoɛ hoɛ ɲəŋ tədʒak həna bebəh leə saŋ doɲə ɲʊɪ kə axee təmoŋ nɛorəkə mɪubətʃʊt nə jum di ɲawʊŋ orəoŋ pɛʊpəo meʊlinteʊŋ dɪlabʊih sədʒa ɲəŋ kəoh səubab ɲən hai təoŋko pijɪuŋ sɛorətə orəoŋ hərʊik merdɛka
human_rights_un_ace_adam_64kb_0011	ʊai neomboi lhəe tʃoba timəŋ lɔm ətoɛ ŋon hʊkʊm hək asəse mənʊsɪə ɲəŋ kəoh tʃəra peʊtɛunəŋ kəom lewat ɛʊʃərɪkatən əŋsaəŋsə kəopeʊt disəobut pɪukʊŋ hʊbʊŋan ŋon dən rəkan di ləo nɛoɡərə ɲəŋ kəulɪmɔŋ xɛon ɪaɡam ɲən pɪujəkɪn bandum kəo hək asəse mənʊsɪə ɲəŋ kəulɪmɔŋ hərʊih tapɪotraŋ haxək ɡɪʊtaɲɔɛ bɪk təok mɪʊtʃəwʊe mɛurəbəraba
human_rights_un_ace_adam_64kb_0012	ʊai mərtəbat həreʊkət ʊmət ɲʊɪ hək sɪʊnərʊe bandum mənʊsɪə inɔŋ ŋon əɡəm doɛk bək sarɪə dʒəot maŋət tapekɛe kɪumədʒuən bɛosəmə odəp lɛubəh ɡɪt kəo sɛorətə olɛe sʊpaja bɪk məopəkɛe sɛosəmə ʃədara
human_rights_un_ace_adam_64kb_0013	ʊai kəunam bandum səʊpakət doŋ bək rəpat deʊŋʊn bandum bəŋsa soarə kə bolat dʒundʒoŋ thətthət hək asəse ɲəŋ kɛutʊdʒɔh bək mophʊm beothat lɛubəh məʊkarət bebəh merdɛka ɲəŋ pəlɪŋ pɪonteŋ bəh pəutɛʊpat tʃəra pəuseolamət dʒandʒɪ ɲəŋ kəna dʒenɔɛ məulaŋkah kɪ
human_rights_un_ace_adam_64kb_0014	eʊɲətəan mum adʒɛuleh mum
human_rights_un_ace_adam_64kb_0015	ɛʊʃərɪkatən aŋsəəŋsəsoai ɲəŋ kə kəjem tə xɪonxəʊn hək asəse bandum ʊmət mənʊsɪə eʊɲətəan mum ɲən kəo ʊkorən omom kəo teeptiɪp bəŋsa sɛoɡələ nɛoɡərə ɲʊɪ təmʊphom eʊɲətəan ɲən dum dʒəot təsʊsʊn sɪonɔn bandum reʊntʃana ɲəŋ dɪsɪobutseʊbʊt nebak phonphon tabɪə kəo kəom ədʒərən ŋon dɪdəkən ɲətə deʊŋʊn ɲən ɡɪʊtaɲɔɛ məken təmʊphom haxək kəom kəo bebəh merdɛka lɔm nebak ɲən pəorɪuleə lɛubəh tapɪʊmədʒu lɛubəh təpəʊmeoseuhuɛ darɪ ɲəŋ kə kə lɛubəh dimʊphʊm lɪ kəom lɛubəh deakoə təxɪon ebarat lampoɪ dəlam ɡeoleta
human_rights_un_ace_adam_64kb_0016	asai
human_rights_un_ace_adam_64kb_0017	andum mənʊsɪə lahɪə bebəh merdɛka deʊŋʊn hək ŋon mərtəbat ɲəŋ səma
human_rights_un_ace_adam_64kb_0018	ɡɔn akai təsəʊmɪkɪɪ ŋon ətee taməorasa bandum ɡɪʊtaɲɔɛ laɡɪə ʃədara
human_rights_un_ace_adam_64kb_0019	asai
human_rights_un_ace_adam_64kb_0020	iɪp orəoŋ nə hək səban bandum bebəh ləm ɡrak bebəh ləm bɪtʃara məunan kəoh dexɛon ləm eʊɲətəan mum eurɪoləe thətthət tapham wahɪə ʃədara eʊɲətəan ɲən həna keʊtʃoəlɪe ropa ŋon heɛ pʊtəh ŋon ɪtəm inɔŋ ŋon əɡəm brɔk ŋon tarɪə depandaŋ sahɪə orɔɪ ŋon məlam
human_rights_un_ace_adam_64kb_0021	əsə əɡama sʊkeɛ ŋon bəŋsa həna dɪpeobidə məunan tʃit sekap pʊlitek pəŋkət hək mɪlək ɡəsiɪn ŋon kəja depandaŋ seoropa wahai pʊtʃʊt ədek kɪodʊdʊkan pʊlitek hʊkʊm nəŋroɪ orəoŋ sedrʊədroə merdɛka dʒədʒəhən ətawa seutɪoŋɔh dʒədʒəhən həme dɪtilek dən dɪsidek handʒeut deherɔə doɛk bək sədʒan doŋ peɛh bək səban
human_rights_un_ace_adam_64kb_0022	asai
human_rights_un_ace_adam_64kb_0023	rɪuŋ drɔɛdroɪ bək dʒəmɪʊn dʒenɔɛ handʒeut bɔh ətoɛ kəo orəoŋ leŋka karɛʊna nə hək odɛep drɔɛ di dəlam doɲə həme tapɛokarue wahɪə ʃəɛdərə
human_rights_un_ace_adam_64kb_0024	asai
human_rights_un_ace_adam_64kb_0025	ənə sidrʊɪ orəoŋ bək dʒəmɪʊn dʒenɔɛ dʒəot bɔh ətoɛ kəo orəoŋ leŋka təpɪubudək taprah tədʒədʒəh təpɛoroɡɔɪ boɛt ɲən dɪlaraŋ dʒenɔɛ ŋon teumə
human_rights_un_ace_adam_64kb_0026	asai
human_rights_un_ace_adam_64kb_0027	ən sidrʊɪ orəoŋ patɔt taseksə dʒəot tadɛʊra pɛutʊrɔt pəlak ətawa təhʊkʊm banban nə həwa ətawa təhɪna banban nə ɡəlak
human_rights_un_ace_adam_64kb_0028	asai
human_rights_un_ace_adam_64kb_0029	eɛptiep orəoŋ tʃit nə hək drɔɛ nə hək məoŋakʊɛ di lɪkeʊ hʊkʊm tapɪʊləku orəoŋ ɲən səbaɡɔə pribəde drɔ handʒeut bɛurəŋsɔɛ təpobuɛt konkʊn
human_rights_un_ace_adam_64kb_0030	asai
human_rights_un_ace_adam_64kb_0031	iɪp orəoŋ səban bək məta hʊkʊm səlah ŋon beunə tə kalɔn teumə teɛp orəoŋ nə hək lendʊŋan hʊkʊm tən nə beda deʊŋʊn ləen mənʊsɪə
human_rights_un_ace_adam_64kb_0032	atɔt hai rəkan təɲʊe təpʊphom handʒeut hai ampɔn təpɛobidəbidə dʒɪlaih ɲən məunɛuntaŋ eʊɲətəan mum əontəŋ əkək sasɪ ənʊsea
human_rights_un_ace_adam_64kb_0033	asai
human_rights_un_ace_adam_64kb_0034	iɪp orəoŋ nə hək təurɪmɔŋ ɲən lɪ orəoŋ tʃəroŋ dexɛon pɪmulɪhən ɪfektif darɪ ɲəŋ disəobut pəŋədilan nəsɪonəl jaŋ kɔmpətɪn jaknɪ kəo sɛoɡələ tɪndakən ɲəŋ məoləŋɡə haxək fʊndamɛntəl ɲəŋ dɪdʒʊk kɪ ɡɔb ɲən lɪ ondaŋundəŋ dəsa ətawa hʊkʊm
human_rights_un_ace_adam_64kb_0035	asai
human_rights_un_ace_adam_64kb_0036	ənə sidrʊɪ orəoŋ hai tʃotwa ɪnsəon dʒəot bən seʊwenəŋwɪnaŋ dedrʊp ŋon dɪtheun ətawa dɪbʊh depəʊəsɛŋ di oteʊn di remba ətawa dɪŋən ləen tʃəra ɲəŋ tək sɛmɛunameuna
human_rights_un_ace_adam_64kb_0037	asai
human_rights_un_ace_adam_64kb_0038	andum orəoŋ hai təoŋko rədʒa ətɪoh peuradilən nə səban hək peuradilən ɲəŋ ədee ŋon teoboka leə pəʊŋədelan bebəh həna mɪʊmɪhək
human_rights_un_ace_adam_64kb_0039	asai
human_rights_un_ace_adam_64kb_0040	arəŋəsɔɪ didakwə leə hʊkʊm handʒeut hai kəom təpeʊɡəh səlah prəh dɪleɛ pəʊŋədelan teoboka pɪoɡʊt pʊtʊsan deʊŋʊn dʒamɪnən dʒəulah pəʊŋədelan bebəh
human_rights_un_ace_adam_64kb_0041	ənə sidrʊɪ orəoŋ dʒəot tapəʊsəlah jɔh ɡɔh dʒəulah məoləŋɡə hʊkʊm eobab səlah ŋon beunə ɡɔh lɔm səh jɔh ɡɔh depʊtʊih leə toənku hakim
human_rights_un_ace_adam_64kb_0042	asai
human_rights_un_ace_adam_64kb_0043	okom nəsɪonəl dən entərnəsɪʊnal peɛh dɪpeuɡah handʒeut xɛon səlah watɪə boɛt ɲən təudʒəde handʒeut pəubɛʊrat hʊkʊman si səlah darɪ ɲəŋ hərʊih təudʒəde hai təoŋko sɪdi
human_rights_un_ace_adam_64kb_0044	asai
human_rights_un_ace_adam_64kb_0045	eɛptiep orəoŋ nə hək dedʒak hʊehoɛ ɲəŋ ɡəlak bandum orəoŋ nə hək hai tʃut ədoɛ təduɪk ləm bataihbətaih sabɔh nəŋɡrɔe
human_rights_un_ace_adam_64kb_0046	eɛptiep orəoŋ nək hək drɔɛ penah darɪ səbʊih nəŋɡrɔe ʊ ləen nəŋɡrɔe tɪuməsʊk nəŋɡrɔe dʒeɛh kɛodroe dən wɔ teumə ʊ naŋɡrʊ drɔɛ
human_rights_un_ace_adam_64kb_0047	asai
human_rights_un_ace_adam_64kb_0048	andum orəoŋ deʊŋʊn neɛt drɔɛ nə hək wɪh ʊ rantoɪ meta soakə ɲəŋ kəoh tʃəra wəhəe samlakoe tapɛuplʊeŋ drɔɛ darɪ hʊkʊm remba
human_rights_un_ace_adam_64kb_0049	ek tapəʊsəban wəhəe ɲək əwən ŋon pɛundʒəhət kɔn pʊlitek ɲəŋ depɪoplʊeŋ drɔɛ ətawa boɛt ŋon tɪndakən ɲəŋ məʊlawən dəsa ŋon tʊdʒoən bonɔɛ
human_rights_un_ace_adam_64kb_0050	asai
human_rights_un_ace_adam_64kb_0051	iɪp orəoŋ nə hək maseŋməseŋ drɔɛ mɛoɡəntɔe nəŋɡrɔe pət ɲəŋ soka məunan xɛon wahɪə paŋ nəŋɡrɔe tɛʊntaŋ ɡantoɪ mɛoɡəntɔe wərɡa nɛoɡərə
human_rights_un_ace_adam_64kb_0052	ənə barəŋsʊe bən maŋət əsoɛ drɔɛ peubatəʊ hək wərɡa nɛoɡərə orəoŋ sedrʊədroə ətawa banban ɡəlak pɪʊtʊlək hək orəoŋ ɲəŋ mɛuɡanto wərɡa nɛoɡərə laɡɪə penah sɪuŋ
human_rights_un_ace_adam_64kb_0053	asai
human_rights_un_ace_adam_64kb_0054	ɪuɲɔe bən bandum ɡəlak bɔk rambɔt həna leə laɡɔt kʊneŋ bɔh ləŋsət meʊɲɔə inɔŋ ŋon əɡəm omuɪ dʒih kə tʃɔt bɪodʊh hai rəkan meʊkəwən ləuɡat əɡəm ətawa inɔŋ kəna hək dʒih hək mɪʊnɪkəh ŋon meokɪʊlʊarɡə
human_rights_un_ace_adam_64kb_0055	ək meʊkəwən ŋon mɪutʃhrɪə pih həna pandaŋ bəŋsa wərɡa nɛoɡərə ŋon əɡama
human_rights_un_ace_adam_64kb_0056	rɪuŋ ɲəŋ meʊkəwən hai pʊtəh lɪtʃən tə xɛon moŋken ŋon pɪlɪhan drɔɛ lintʊɪ ŋon dəra barʊə pɪudʒətʊh pɪlɪhan hən dʒəot dʒetham leə barəŋsʊe
human_rights_un_ace_adam_64kb_0057	jəh mə ŋon ənɛʊkəneuk ɲʊɪ nə məunan təxɪon hai ənɪok təoŋko di bərat sabɔh kɪusətuən ələmiəh maʃarəkət ɲəŋ mɪndəsa bandum nə lendʊŋan darɪ nɪɡərə ŋon maʃarəkət
human_rights_un_ace_adam_64kb_0058	asai
human_rights_un_ace_adam_64kb_0059	ə hək ətɪoh atrə baɡɪ teeptiɪp orəoŋ sedrʊədroə ətawa bɛosəmə hən dʒəot dɪpeukərʊɛ lɪ sedrʊədroə orəoŋ
human_rights_un_ace_adam_64kb_0060	andum ɡɪʊtaɲɔɛ bebəh tapeumɪuɡah pəutɛʊbɪt pɛundəpət hansoɪ dʒəot tʃəuɡah enfɔrmase ŋon əsoɛ pɪkərən bebəh tə meta bebəh təurɪmɔŋ ŋon tapeʊtrʊk tən bataih welajəh
human_rights_un_ace_adam_64kb_0061	asai
human_rights_un_ace_adam_64kb_0062	iɪp orəoŋ nə hək wəhəe ɲək ɪntən ətɪoh kɛbɪʊbəsən pɪkərən əɡama ŋon ətee nuranie tɪuməsʊk mɛuɡanto əɡama ətawa kɛpeotʃəjaan məunan kəoh dipɪuphəm leə eʊɲətəan mum sʊpaja mɛusampo wahɪə samlako ədʒərən ɲən hərʊih tapəʊədʒa tapɛʊbʊɪt tapəotaət sedrʊədroə ətawa bɛosəmə di lɪkeʊ omom ətawa sedrʊədroə ŋon bɛurəŋsɔɛ
human_rights_un_ace_adam_64kb_0063	asai
human_rights_un_ace_adam_64kb_0064	andum ɡɪʊtaɲɔɛ bebəh tapeumɪuɡah bebəh təsaŋɡah bebəh tapɪʊɲʊə həna sidrʊɪ orəoŋ dʒit dɪtʃeuɡah pɛʊpəo ɲəŋ təpeʊɡəh bən səban orɔɪ meta təurɪmɔŋ ŋon pəotrok enfɔrmase dən əsoɛ pɪkərən peɛh handʒeut soɛ tham peɛh bebəh taŋɛʊi teɛp mɪdea həna bətəsən di dəlam nəŋɡrɔe ətawa loa rantoɪ
human_rights_un_ace_adam_64kb_0065	asai
human_rights_un_ace_adam_64kb_0066	əɲoɪ peɛh nə hək mɛosəpatsəpat tə peʊdʊɛk rəpat tə pəuɡah həba handʒeut soɛ tʃəuɡah hən dʒəot soɛ ʊmpət handʒeut soɛ nə tham ŋon tʃəra pəksa
human_rights_un_ace_adam_64kb_0067	ə hək bək təɲʊe bɪudʊŋ kʊmpɔlən mɛokəwankəwan ekot peʊmɪlu hən dʒəot soɛ pəksa ekot kʊmpɔlən ɡɪʊtaɲɔɛ bebəh thətthət bək taməoɪkoɛ
human_rights_un_ace_adam_64kb_0068	asai
human_rights_un_ace_adam_64kb_0069	kɔt peʊmɪlu laŋsoŋ ŋon bebəh pɪləh wakɪləh ɲəŋ tapəotʃaja bɪk səlah pɪləh əwək wakɪləh batʃut məʊsaləh pɪləh ɲəŋ boja
human_rights_un_ace_adam_64kb_0070	əonaŋ ŋon talʊə kɔn məsələh dʒodʒɔɛ ŋon əde pəlɪŋ otamə nə hək tətʊrʊt ləm pəmɪurintəh meʊɲɔə ɲʊɪ tʃəudah pɪmpən nɛoɡərə
human_rights_un_ace_adam_64kb_0071	jaŋ handʒeut tatʊlək kɛohəondək rakjat ləm bandum teompat ləm koasə nɛoɡərə kɛohəondək rakjat haroɪh pəutɛʊɡah pɛundəpət lewat peʊmɪlu ɲəŋ dʒodʒɔɛ ədee bebəh rahasɪa peʊmɪlu məosəuti murnɪɪ ŋon təutap omom səudeoradʒət bebəh ŋon rəhsiə dʒəot tʃih ŋon tʃəra ləen ɲəŋ səma mantap tapɪ ɲəŋ pɪonteŋ bebəh ŋon rəhsiə
human_rights_un_ace_adam_64kb_0072	asai
human_rights_un_ace_adam_64kb_0073	iɪp orəoŋ sɪʊbəɡʊe wərɡa maʃarəkət nə hək ətɪoh dʒamɪnən sʊseai ɲəŋ otamə orəoŋ ɲəŋ pəlɪŋ məʊkarət bɪk tɔk dimetə həreʊkət deʊŋʊn məoɡədɛe ɲəŋ bandum pəorɪuleə demi mərtəbat drɔɛ sidrʊɪ pribəde ɲəŋ tɪmʊh bebəh merdɛka rɔt useuhauseoha ləm nəŋɡrɔe ŋon loa rantoɪ ɲəŋ deorʊih ŋon sʊmbər dəja teɛp nɛoɡərə
human_rights_un_ace_adam_64kb_0074	asai
human_rights_un_ace_adam_64kb_0075	iɪp orəoŋ nə hək ətɪoh boɛt oseoha bebəh dɪpileh pəo ɲəŋ dʒeɛh soka dʒeɛh peɛh nə hək ətɪoh ʃəratʃərat boɛt ɲəŋ ədee sɛorɛʊta hək lendʊŋan darɪ pɪuŋaŋɡʊrən
human_rights_un_ace_adam_64kb_0076	eɛptiep orəoŋ hai əɡəm meutuah handʒeut nə diskreminase dəlam hai ʊpəh kəo boɛt jaŋ səban bəurat ŋon reŋən inɔŋ ŋon əɡəm handʒeut nə beda
human_rights_un_ace_adam_64kb_0077	iɪp orəoŋ kɛorɛʊdʒa nə hək kəo ʊpəh ɲəŋ ədee dən mɛʊontɔŋ ɲəŋ kə dʒəulah ɲəŋ nə dʒəmɪnan odɛep ɲəŋ nə mərtəbat nə lendʊŋan sʊseai kəo drɔ ŋon kəʊrabət
human_rights_un_ace_adam_64kb_0078	iɪp orəoŋ nə hək pɪudʊŋ kʊmpɔlən dən təmoŋ ʃarɪkətʃarikət səokɛurəʊdʒə ɲəŋ nə ɲən kəoh tʃəra pəʊlindʊŋ drɔɛ darɪ kəom madʒɪkən ɲəŋ seʊwenəŋwɪnaŋ
human_rights_un_ace_adam_64kb_0079	asai
human_rights_un_ace_adam_64kb_0080	rɪuŋ kɛorɛʊdʒa kɔn bodak dolat ɲəŋ patɔh bolat bək toənku rədʒa təɲʊ peɛh nə hək taməoʃərekat kəo təmeʊmʊpakət kɪ səudʒahtəʊra
human_rights_un_ace_adam_64kb_0081	asai
human_rights_un_ace_adam_64kb_0082	iɪp orəoŋ nə hək kɪ tərap odɛep dʒrɔh nə dʒamɪnən kɛosehatən kɪ drɔɛ ŋon ənɪok benɔɛ tɪuməsʊk hək kəo iɪ ŋon boɛ pakaian ŋon rʊmʊh kəosɛdʒahteraan ŋon dʒamɪnən sʊseai haroɪh deherɔə dʒamɪnən peɛh beunə kɪ əwək meŋaŋɡɔe jaŋ səket ŋon tʃətʃat trəp ŋon barʊə ɲəŋ dʒandadʒəndə ŋon landʒɔt usea sɛorɛʊta kəom ɲəŋ kurɪuŋ bəʊlandʒa
human_rights_un_ace_adam_64kb_0083	ə ŋon ənɪok bɪk mɪutaŋelaŋ bək nə beʊrɛudʒəŋ rəwətən ŋon bantʊən bandum ənɪok tɪuməsʊk ɲəŋ lahɪə hərɪʊm dʒamɪnən sʊseai nɛoɡərə hərʊih nə kəo əwək ɲən
human_rights_un_ace_adam_64kb_0084	asai
human_rights_un_ace_adam_64kb_0085	ək teɛp ənɪok təmoŋ sikolə wahɪə jə əjəh ɲəŋ həna beajə pəlɪŋ obet sikolə rɛndəh pɪondɪdɪkan reondah məosəuti pɪuwədʒɪb sʊpaja teɛp ənɪok sikolə təurɛʊtɪb
human_rights_un_ace_adam_64kb_0086	əondɪdikən təukɛʊnɪk ŋon dʒʊrʊsan hərʊih dʒəulah haroɪh təupɛʊhah loah kəo orəoŋ leŋka məunan tʃit lɔm pɛondidɪkən təŋɡɪ hərʊih tʃit kəo orəoŋ leŋka səma səukəle
human_rights_un_ace_adam_64kb_0087	ɛʊndedɪkan məosəuti peʊkɛuməŋ pribəde dən pɪukʊŋ peʊŋharɡəan hək asəse ɛbebesan fʊndamɛntəl bɪk həna təturɪ bandum ɲən səban pɪonteŋ laɡɪə boɛ ŋon iɪ
human_rights_un_ace_adam_64kb_0088	nəok meɛt laɡɪə iɪ beɛt ŋon boɛ pʊtəh sʊtʃi mʊrnɪ laɡɪə kɛrtəh ɡɔh təutoləh orɛoŋtoə inɔŋ ŋon əɡəm wədʒeb tapham əwək ɲən hərʊih dɪbimbɛŋ watɪə pɪləh pɛondidɪkən
human_rights_un_ace_adam_64kb_0089	asai
human_rights_un_ace_adam_64kb_0090	joɛ nə sikolə orəoŋ dʒəot tʃəudah tʃəroŋ dɪpeuɡah sɛoɡələ ropa səubab ɲən pɪurɪulɪ nə kɛobebasən peʊkɛuməŋ ɪləumɪ ŋon kɛubʊdəjaən
human_rights_un_ace_adam_64kb_0091	jaŋ həna modah tə tʃepta kərja kərja ɪlɪumɛe sɪoni sastra ŋon bʊdaja oləh səubab ɲən pɪurɪulɪ lendʊŋan kərja ɪlmɪəh sɪoni sastɛura ŋon bʊdaja
human_rights_un_ace_adam_64kb_0092	asai
human_rights_un_ace_adam_64kb_0093	eɛptiep orəoŋ nə hək ətɪoh səbʊih tətənən sɔsɪa ŋon entərnəsɪʊna məunan bək tapham ləm tətənən ɲən haxək dən kɛobebasən ləm eʊɲətəan ɲo pəorɪuleə teʊlaksana pɪonʊh bək sədʒan
human_rights_un_ace_adam_64kb_0094	asai
human_rights_un_ace_adam_64kb_0095	eɛptiep orəoŋ hai bʊŋɔŋ kərɛoŋ nə keuwadʒibən kəo maʃarəkət loah maʃarəkət teompat teeptiɪp orəoŋ peʊkɛuməŋ keʊpribədɪan ŋon həna bətah
human_rights_un_ace_adam_64kb_0096	eɛptiep orəoŋ nə hək ŋon kɛobebasən ləm tapəʊdʒəlan məunan pəorɪuleə təxɪon teɛp orəoŋ haroɪh tondʊk kəo batəsənbatəsan jaknɪ ondaŋundəŋ ŋon peuraturən tʊdʒoən ondaŋundəŋ təakoɛ təpɪuhɔrmət hək ŋon kɛobebasən orəoŋ ləen dən kəo tapəʊdʒəlan ʃəratʃərat ɲəŋ ədee ləm axlək kɛutɛrtiban dən kɛsɛodʒehtɛrəan omom ləm maʃarəkət dəmʊkrates
human_rights_un_ace_adam_64kb_0097	ək ŋon kebɪbasan ɲən hai ɲək bintəŋ səma səukəle handʒeut məutɛuntaŋ ŋon tʊdʒoən dən prensɪpprɪnsɪp ɛʊʃərɪkatən əŋsaəŋsə
human_rights_un_ace_adam_64kb_0098	asai
human_rights_un_ace_adam_64kb_0099	ən dʒəot nə səbʊih dəlam eʊɲətəan ɲʊɪ tə pəʊsaləh tafsɛe hai bʊŋɔŋ padɪə jaknɪ məupɛʊdʒʊk hək kəo sabɔh nɛoɡərə keulɔmpɔk ətawa orəoŋ si drɔɛdroɪ
human_rights_un_ace_adam_64kb_0100	akni hək tɪʊlɪbət ləm teɛp keʊɡɪətən ɲəŋ məukɛʊsʊd meʊpəʊrosək haxək ŋon kɛobebasən ɲəŋ nə dəlam eʊɲətəan ɲʊɪ səlah tafsɛe ɲən handʒeut nə bəo obɛe udʒuŋ padɪə
