human_rights_un_swe_adam_64kb_0001	œrɛnta ɑːtiːɔnɛrnɑːs jɛneːralføːrsɑːmlɪŋ antɔɡ uːɧ ɕɵnjuːrdeː dɛn dɛsɛmbɛr eːn ɑːllmɛːn føːrklɑːrɪŋ uːm deː mɛnɧlɪŋɑː rɛːttɪɡhɛteːrnɑː
human_rights_un_swe_adam_64kb_0002	œrklɑːriːŋɛn ɑːntuːjs meːd jarœsteːr
human_rights_un_swe_adam_64kb_0003	ŋeːt land røːstɑːdeː ɛmuːt
human_rights_un_swe_adam_64kb_0004	tta lɛːndeːr ɑːvstuːd
human_rights_un_swe_adam_64kb_0005	meːdɛlbart ɛfteːr deːnnɑː hiːstɔriːɧa hɛndɛlseː ʉːppmɑːnadɛ jeːnɛralføːrsamlɪŋeːn ɑːlla mɛdlɛmsstateːr att ɔffeːntlɪɡjøːra fœrklɑːrɪŋɛns teːkst uːɧ att jœra dɛn spriːdd ɕɛnd lɛst uːɧ fœrstoːdd frɑːmføːr allt ɪ ɧuːlɔr uːɧ andrɑː ʉːndɛrvɪsniːŋsiːnstɪtɵtiːɔnɛr ɵtɑːn hɛnsʏn tiːll ɔliːka lɛːndeːrs ɛlleːr rɛjɪɔnɛrs pɔliːtɪɧa fœrhoːllɑːndeːn
human_rights_un_swe_adam_64kb_0006	œrklarɪŋeːns ɔffiːsiːɛllɑː teːkst fiːnns tɪlljɛŋliːɡ poː s seːks ɔffiːsiːɛllɑː sproːk ɑːrabɪɧa eːŋeːlɧa frɑːnɧa ɕɪnɛsiːɧɑː ryːɧɑː uːɧ spɑːnɧa
human_rights_un_swe_adam_64kb_0007	ɪdɑːreː har eːn rad eːnɧiːlda mɛdleːmslɛːndeːr høːrsammɑːt jɛnɛrɑːlfœrsamliːŋeːns ʉːppmaniːŋ uːɧ øːvɛrsatt føːrklɑːrɪŋeːn
human_rights_un_swe_adam_64kb_0008	eːn sveːnɧɑː øːvɛrsɛːttnɪŋeːn pɔfœjɑːndeː sɪduːr har juːdkɛːnts av sveːnɧɑː reːjeːrɪŋeːn
human_rights_un_swe_adam_64kb_0009	iːd hɛnvɛːndeːlsɛ tiːll s nuːrdɪɧa iːnfuːrmɑːtiːɔnɧɔntuːr ɪ œpeːnhamn ɕɑːn jrɑːtɪsɛksɛmplar beːstɛllɑːs av føːrklɑːrɪŋeːn poː s seːks sproːk sveːnɧɑː uːɧ øːvriːŋa nuːrdɪɧa sproːk samt eːtt beːɡrɛːnsat antɑːl andrɑː sproːk
human_rights_un_swe_adam_64kb_0010	
human_rights_un_swe_adam_64kb_0011	
human_rights_un_swe_adam_64kb_0012	nɛr eːrkɛnnɑːndɛt av deːt iːnneːbɔɛndɛ vɛrdɛt huːs ɑːlla meːdlɛmmar av mɛnnɪɧuːslɛkteːt uːɧ av deːrɑːs lɪka uːɧ uːfœrʏttɛrlɪja rɛttiːjhɛtɛr ɛr jrʉːndvalɛn føːr friːhɛt rɛːttvɪsa uːɧ freːd ɪ vɛːrldɛnɛnɛːr rɪŋɑːktnɪŋ uːɧ føːrɑːkt føːr deː mɛnɧlɪŋɑː rɛːttɪɡhɛteːrnɑː leːtt tiːll bɑːrbarɪɧa jɛrnɪŋɑːr suːm ʉːpprøːrt mɛːnɧliːɡhɛteːns samvɛteː uːɧ ɛnɛr ɧɑːpɑːndeːt av eːn vɛrld dɛr mɛnnɪɧuːrnɑː oːtnjɵtɑː ʏttrandeːfrɪheːt trɔsfrɪheːt samt friːhɛt frɔn frʉːktan uːɧ nøːd ɕɵnjuːrts suːm fɔlkeːns hœŋstɑː strɛːvɑːneːnɛr deːt ɛr vɛseːntliːjt føːr att iːkɛ mɛnnɪɧan ɧall tvɪŋɑːs att suːm eːn sɪsta ʉːtvɛɡ tɪllɡrɪpa ʉːppruːr muːt tyːrɑːnniː uːɧ føːrtryːk att deː mɛnɧlɪŋɑː rɛːttɪɡhɛteːrnɑː ɧʏddɑːs jɛnuːm lɑːjeːns øːveːrhœɡheːtɛnɛːr deːt ɛr vɛseːntliːjt att frɛːmja ɵtvɛklɑːndeːt av vɛnɧaplɪŋa føːrbiːndɛlseːr meːllɑːn nɑːtiːuːnɛrnɑːɛnɛːr œrɛnta ɑːtiːɔnɛrnɑːs fuːlk ɪ stɑːdjan ɔnʏuː ʉːttryːkt sɪn truː poː deː jrɵndlɛːjjandɛ mɛnɧlɪŋɑː rɛːttɪɡhɛteːrnɑː dɛn eːnɧiːlda mɛːnniːɧɑːns vɛːrdiːjhɛt uːɧ vɛːrdeː samt mɛːnneːns uːɧ ɕvɪnnuːrnɑːs lɪka rɛttiːjhɛtɛr ɛvɛnsɔm beːslʉːtat frɛːmja sɔsɪɑːlt frɑːmɔtɧrɪdandɛ uːɧ bɛttrɛ lɛvnadsviːllkuːr ʉːndeːr støːrrɛ friːheːtɛnɛr mɛdleːmsstɑːtɛrna ɔtajiːt siːɡ att ɪ samvɛrkɑːn meːd œrɛnta atɪɔneːrnɑː sɛːkeːrstɛːlla ɑːllmɛːn uːɧ ɛffeːktiːv reːspɛkt føːr deː mɛnɧlɪŋɑː rɛːttɪɡhɛteːrnɑː uːɧ deː jrɵndlɛːjjandɛ friːhɛteːrnaeːnɛːr eːn jeːmeːnsɑːm ʉːppfattniːŋ av deːssɑː friː uːɧ rɛttiːjhɛtɛrs ɪnneːbœrd ɛr av stœrsta bɛtyːdɛlseː føːr ʉːppfʏllandɛt av deːttɑː ɔtaŋɑːndɛkɵŋøːr
human_rights_un_swe_adam_64kb_0013	deːnnɑː sɔsuːm eːn jeːmeːnsɑːm riːktlɪnjeː føːr ɑːlla fuːlk uːɧ ɑːlla nɑːtɪɔneːr poː deːt att vɑːrjeː ɪndiːviːd uːɧ vɑːrjeː sɑːmhɛːllsɔrŋɑːn moː meːd deːnnɑː føːrklɑːrɪŋ ɪ ɔtɑːnkɛ stɛndiːŋt strɛːva ɛfteːr att jɛnuːm ʉːndɛrvɪsnɪŋ uːɧ ʉːppfuːstran beːfɔrdra reːspɛktɛn føːr deːssɑː friː uːɧ rɛttiːjhɛtɛr samt jɛnuːm framsteːŋsfrɛmjɑːndɛ iːnhɛmɧa uːɧ iːntɛrnɑːtiːuːneːlla ɔtjɛːrdeːr sɛːkeːrstɛːlla deːrɑːs allmɛːnna uːɧ vɛrksamma eːrkɛnnandɛ uːɧ tɪlllɛmpnɪŋ sɔvɛl bland fɔlkeːn ɪ mɛdleːmsstɑːtɛrna suːm bland fɔlkeːn ɪ uːmroːdɛn ʉːndeːr deːrɑːs øːvɛrhøːjhɛt
human_rights_un_swe_adam_64kb_0014	rtiːkɛl
human_rights_un_swe_adam_64kb_0015	lla mɛːnniːɧɔr ɛːruː føːddɑː frɪa uːɧ lɪka ɪ vɛːrdeː uːɧ rɛttiːjhɛtɛr
human_rights_un_swe_adam_64kb_0016	ɛ ɛːruː ʉːtrɵstɑːdɛ meːd fœrnɵft uːɧ samvɛteː uːɧ bœra handlɑː jeːntɛmuːt varɑːndra ɪ eːn andɑː av brɔdeːrɧɑːp
human_rights_un_swe_adam_64kb_0017	rtiːkɛl
human_rights_un_swe_adam_64kb_0018	nvar ɛr bɛrɛttiːŋad tiːll ɑːlla deː friː uːɧ rɛttiːjhɛtɛr suːm ʉːttalɑːs ɪ deːnnɑː føːrklɑːrɪŋ ɵtɑːn ɔtɧɪllnad av nɔŋɔt slaɡ sɔsuːm ras hʉːdfɛrɡ ɕøːn sproːk rɛlɪjiːɔn pɔliːtɪɧ ɛlleːr annɑːn ʉːppfattniːŋ nɑːtɪɔneːllt ɛlleːr sɔsɪɑːlt ɵrsprʉːŋ eːjɛnduːm bøːrd ɛlleːr stɛllniːŋ ɪ œvriːjt
human_rights_un_swe_adam_64kb_0019	ŋeːn ɔtɧɪllnad moː viːdɑːrɛ jœras poː jrɵnd av dɛn pɔliːtɪɧa jʉːriːdɪɧa ɛlleːr iːntɛrnɑːtiːuːneːlla stɛllniːŋ suːm ɪntajeːs av deːt land ɛlleːr ɔmroːdɛ tiːll vɪlkeːt eːn peːrsɔn høːr vɑːreː siːɡ deːttɑː land ɛlleːr ɔmroːdɛ ɛr ɔbɛruːɛndɛ stoːr ʉːndeːr føːrvaltɑːrɧap ɛr iːkɛɧɛːlvstyːrɑːndeː ɛlleːr ɛr ɵndɛrkastat noːjuːn annɑːn bɛŋrɛnsnɪŋ av sɪn sʉːvɛrɛːnɪteːt
human_rights_un_swe_adam_64kb_0020	rtiːkɛl
human_rights_un_swe_adam_64kb_0021	nvar har rɛtt tiːll liːv friːhɛt uːɧ peːrsɔnliːɡ sɛːkeːrhɛt
human_rights_un_swe_adam_64kb_0022	rtiːkɛl
human_rights_un_swe_adam_64kb_0023	ŋeːn moː hɔllas ɪ slavɛriː ɛlleːr trɛːlduːm
human_rights_un_swe_adam_64kb_0024	slavɛriː uːɧ slavhɑːndeːl ɪ ɑːlla deːss fuːrmɛr ɛːruː fœrbjʉːdna
human_rights_un_swe_adam_64kb_0025	rtiːkɛl
human_rights_un_swe_adam_64kb_0026	ŋeːn moː ʉːtsɛttɑːs føːr tuːrtʏr ɛlleːr jryːm uːmɛːnɧliːɡ ɛlleːr føːrnɛdrandɛ bɛhandlɪŋ ɛlleːr bɛstrɑːffniːŋ
human_rights_un_swe_adam_64kb_0027	rtiːkɛl
human_rights_un_swe_adam_64kb_0028	nvar har rɛtt att ɑːlleːstɛdɛs ɛrkɛːnnas suːm peːrsɔn ɪ lɑːjeːns meːnɪŋ
human_rights_un_swe_adam_64kb_0029	rtiːkɛl
human_rights_un_swe_adam_64kb_0030	lla ɛːruː lɪka ɪnføːr lɑːjeːn uːɧ ɛːruː ɵtɑːn ɔtɧɪllnad beːrɛːttɪjadeː tiːll lɪka ɧyːdd frɔn lɑːjeːns sɪda
human_rights_un_swe_adam_64kb_0031	lla ɛːruː beːrɛːttɪjadeː tiːll lɪka ɧyːdd muːt vɑːrjeː ɔtɧɪllnad ɪ striːd meːd deːnnɑː føːrklɑːrɪŋ uːɧ muːt vɑːrjeː frɑːmkɑːllandeː av sɔdɑːn ɔtɧɪllnad
human_rights_un_swe_adam_64kb_0032	rtiːkɛl
human_rights_un_swe_adam_64kb_0033	nvar har rɛtt tiːll vɛrksam jɛlp frɔn siːtt lands bɛhøːrɪŋa duːmstuːlar muːt hɑːndlɪŋar suːm ɕrɛːnka deː jrɵndlɛːjjandɛ rɛttiːjhɛtɛr vɪlka tɪllkuːmmɑː hɔnuːm jɛnuːm laɡ ɛlleːr fœrfɑːttniːŋ
human_rights_un_swe_adam_64kb_0034	rtiːkɛl
human_rights_un_swe_adam_64kb_0035	ŋeːn moː jɔdtyːkliːŋt ɑːnhoːllɑːs fɛːŋslas ɛlleːr landsføːrviːsas
human_rights_un_swe_adam_64kb_0036	rtiːkɛl
human_rights_un_swe_adam_64kb_0037	nvar ɛr ʉːndeːr fɵll lɪkstɛlldhɛt bɛrɛttiːŋad tiːll rɛːttviːs uːɧ uːffɛntliːɡ rɑːnnsaknɪŋ ɪnføːr ɔɑːvhɛːŋɪɡ uːɧ ɔpartɪɧ dɔmstuːl viːd faststɛllɑːndeːt av sɔvɛl hans rɛttiːjhɛtɛr uːɧ ɧʏldɪŋheːteːr suːm vɑːrjeː ɑːnklɑːjeːlseː muːt hɔnuːm føːr bruːtt
human_rights_un_swe_adam_64kb_0038	rtiːkɛl
human_rights_un_swe_adam_64kb_0039	nvar suːm bliːvɪt anklaɡad føːr straffbɑːr jɛrniːŋ har rɛtt att bɛtraktas suːm ɔɧʏldiːɡ tiːll deːss hans ɧɵld bliːvɪt lɑːɡliːjeːn fɑːststɛlld viːd uːffɛntliːɡ rɛtteːŋoːŋ ʉːndeːr viːlkeːn hɑːn ɔtnjɵtiːt ɑːlla føːr siːtt fœrsvar nœdɪŋa jɑːrɑːntɪeːr
human_rights_un_swe_adam_64kb_0040	ŋeːn moː døːmɑːs føːr handliːŋ ɛlleːr ʉːndɛrlɔteːnhɛt suːm viːd tɪdpʉːnktɛn føːr deːss beːjɔɛndɛ iːkɛ var straffbɑːr ɛnliːjt iːnheːmɧ ɛlleːr iːntɛrnɑːtɪɔnɛll rɛtt
human_rights_un_swe_adam_64kb_0041	j heːllɛr moː hœŋrɛ straff ʉːtmɛtɑːs ɛn vad suːm var tɪllɛmpliːɡt viːd tɪdpʉːnktɛn føːr dɛn straffbɑːra jɛːrnɪŋeːns beːjɔɛndɛ
human_rights_un_swe_adam_64kb_0042	rtiːkɛl
human_rights_un_swe_adam_64kb_0043	ŋeːn moː ʉːtsɛttɑːs føːr juːdtʏklɪja iːŋriːpɑːndɛn ɪ froːŋa uːm priːvɑːtliːv famiːj heːm ɛlleːr ɕuːrrɛspuːndeːns eːj heːllɛr aŋreːpp poː hɛdeːr uːɧ ansɛɛndɛ
human_rights_un_swe_adam_64kb_0044	nvar har rɛtt tiːll lɑːjeːns ɧyːdd muːt sɔdana iːŋriːpɑːndɛn ɛlleːr aŋreːpp
human_rights_un_swe_adam_64kb_0045	rtiːkɛl
human_rights_un_swe_adam_64kb_0046	nvar har rɛtt att ɪnuːm vɑːrjeː stats jrɛnsɛr friːtt føːrflʏtta siːɡ uːɧ vɛːja sɪn viːstɛlseːɔrt
human_rights_un_swe_adam_64kb_0047	nvar har rɛtt att lɛːmna vɑːrjeː land ɪnbɛɡrɪpɛt siːtt ɛjeːt uːɧ att oːteːrvɛːnda tiːll siːtt ɛjeːt land
human_rights_un_swe_adam_64kb_0048	rtiːkɛl
human_rights_un_swe_adam_64kb_0049	nvar har rɛtt att ɪ andrɑː lɛːndeːr sœka uːɧ oːtnjɵtɑː frɪstad frɔn fœrfœjeːlseː
human_rights_un_swe_adam_64kb_0050	ɛnna rɛtt moː iːkɛ ɔbeːrɔpas viːd lɑːŋɑː ɔtjɛːrdeːr reːɛllt jrɵndadɛ poː ɪkɛpuːlɪtiːɧa bruːtt ɛlleːr poː hɑːndlɪŋar suːm strɪda muːt œrɛnta ɑːtiːɔnɛrnɑːs ɛːndamɔl uːɧ jrʉːndsatsɛr
human_rights_un_swe_adam_64kb_0051	rtiːkɛl
human_rights_un_swe_adam_64kb_0052	nvar har rɛtt tiːll eːn natiːɔnaliːtɛt
human_rights_un_swe_adam_64kb_0053	ŋeːn moː jɔdtyːkliːŋt beːrœvas sɪn natiːɔnaliːtɛt ɛlleːr fœrmɛnas rɛːttɛn att ɛːndra natiːɔnaliːtɛt
human_rights_un_swe_adam_64kb_0054	rtiːkɛl
human_rights_un_swe_adam_64kb_0055	ɵllvʉːksna mɛːn uːɧ ɕvɪnnɔr har rɛtt att ɵtɑːn noːjuːn iːnɧrɛnkniːŋ poː jrɵnd av sɪn ras natiːɔnaliːtɛt ɛlleːr rɛlɪjiːɔn iːŋoː ɛːktɛnɧap uːɧ biːldɑː famiːj
human_rights_un_swe_adam_64kb_0056	ɛ ɛːŋa lɪka rɛttiːjhɛtɛr viːd jɪfteːrmoːl ʉːndeːr ɛːktɛnɧap uːɧ viːd ɛːktɛnɧaps ʉːppløːsniːŋ
human_rights_un_swe_adam_64kb_0057	ɕtɛnɧap moː iːŋoːs ɛndast meːd deː blɪvɑːndeː mɑːkarnɑːs frɪa uːɧ fɵllstɛndiːŋa samtʏkɛ
human_rights_un_swe_adam_64kb_0058	ɑːmɪjeːn ɛr dɛn natɵrliːɡɑː uːɧ jrɵndlɛːjjandɛ eːnhɛteːn ɪ samhɛːlleːt uːɧ ɛːjeːr rɛtt tiːll ɧyːdd frɔn samhɛːlleːt uːɧ stɑːteːn
human_rights_un_swe_adam_64kb_0059	rtiːkɛl
human_rights_un_swe_adam_64kb_0060	nvar har rɛtt att ɛːŋa eːjɛnduːm sɔvɛl ɛnsam suːm ɪ fœrɛniːŋ meːd andrɑː
human_rights_un_swe_adam_64kb_0061	ŋeːn moː jɔdtyːkliːŋt beːrœvas sɪn eːjɛnduːm
human_rights_un_swe_adam_64kb_0062	rtiːkɛl
human_rights_un_swe_adam_64kb_0063	nvar har rɛtt tiːll tɑːnkeːfrɪhɛt sɑːmvɛtsfrɪhɛt uːɧ reːlɪjiːuːnsfrɪhɛt
human_rights_un_swe_adam_64kb_0064	ɛnna rɛtt ɪnnɛfattar friːhɛt att bʏta rɛlɪjiːɔn ɛlleːr truː uːɧ att ɛnsam ɛlleːr ɪ jeːmeːnɧap meːd andrɑː uːffeːntliːɡt ɛlleːr ɛnɧiːlt ɵtœva sɪn rɛlɪjiːɔn ɛlleːr truː jɛnuːm ʉːndɛrvɪsnɪŋ andaktsœvnɪŋar jɵdɧɛːnst uːɧ ɪakttɑːŋɑːndɛ av rɛlɪjiːœsɑː seːdvɛːnjuːr
human_rights_un_swe_adam_64kb_0065	rtiːkɛl
human_rights_un_swe_adam_64kb_0066	nvar har rɛtt tiːll oːsiːktsfriːheːt uːɧ ʏttrandeːfrɪheːt
human_rights_un_swe_adam_64kb_0067	ɛnna rɛtt ɪnnɛfattar friːhɛt føːr ɛnvar att ɵtɑːn iːŋriːpɑːndɛn hʏsa ɔsiːkteːr uːɧ friːhɛt att sœka mɔttaɡa uːɧ sprɪda ɵpplyːsniːŋar uːɧ tɑːnkar jɛnuːm vɑːrjeː slajs ʉːttrʏksmeːdɛl uːɧ ɵtɑːn hɛnsʏn tiːll jrɛnsɛr
human_rights_un_swe_adam_64kb_0068	rtiːkɛl
human_rights_un_swe_adam_64kb_0069	nvar har rɛtt tiːll friːhɛt ɪ froːŋa uːm frɛdlɪjɑː møːteːn uːɧ sɑːmmanslʉːtnɪŋar
human_rights_un_swe_adam_64kb_0070	ŋeːn moː tvɪŋɑːs att tɪllhœra eːn sɑːmmanslʉːtniːŋ
human_rights_un_swe_adam_64kb_0071	rtiːkɛl
human_rights_un_swe_adam_64kb_0072	nvar har rɛtt att tɑːŋɑː deːl ɪ siːtt lands stʏrɛlseː diːreːkt ɛlleːr jɛnuːm friːtt vɑːlda ɔmbɵd
human_rights_un_swe_adam_64kb_0073	nvar har rɛtt tiːll lɪka tɪlltrɛːdɛ tiːll ɑːllmɛːn ɕɛnst ɪ siːtt land
human_rights_un_swe_adam_64kb_0074	ɔlkeːts vɪja ɧall ʉːtjœra jrʉːndvalɛn føːr stɑːtsmakteːrnɑːs myːndiːɡhɛt
human_rights_un_swe_adam_64kb_0075	ɛnna vɪja ɧall ɵttrʏkas ɪ pɛrɪuːdiːɧɑː uːɧ veːrkliːŋɑː val vɪlka ɧuːla ɛːŋa rɵm meːd tɪllɛːmpniːŋ av ɑːllmɛːn uːɧ lɪka rœstrɛtt samt heːmlɪɡ røːstniːŋ ɛlleːr lɪkvɛːrdɪja frɪa rœstniːŋsfœrfɑːrɑːndɛn
human_rights_un_swe_adam_64kb_0076	rtiːkɛl
human_rights_un_swe_adam_64kb_0077	nvar ɛːjeːr ɪ sɪn eːjeːnɧɑːp av samhɛːllsmɛdleːm rɛtt tiːll suːsɪɑːl tryːŋŋheːt uːɧ ɛr bɛrɛttiːŋad tiːll att deː ɛkɔnuːmɪɧɑː sɔsiːalɑː uːɧ ɕʉːltʉːreːlla rɛttiːjhɛtɛr suːm ɛːruː uːɵndjɛŋliːjɑː føːr hans vɛːrdiːjhɛt uːɧ føːr eːn friː ɵtvɛkliːŋ av hans peːrsɔnliːŋheːt fœrvɛrklɪɡas jɛnuːm nɑːtɪɔnɛlla ɔtjɛːrdeːr uːɧ mɛllɑːnfɔlkliːŋt sɑːmɑːrbɛtɛ meːd hɛnsʏn tɑːjeːn tiːll vɑːrjeː stats ɔrjaniːsɑːtiːɔn uːɧ reːsʉːrsɛr
human_rights_un_swe_adam_64kb_0078	rtiːkɛl
human_rights_un_swe_adam_64kb_0079	nvar har rɛtt tiːll arbɛteː tiːll friːtt val av sʏssɛlsɛːttniːŋ tiːll rɛːttvɪsa uːɧ tɪllfrɛdsstɛːllandeː arbeːtsføːrhoːllɑːndɛn uːɧ tiːll ɧyːdd muːt ɑːrbeːtslœɧeːt
human_rights_un_swe_adam_64kb_0080	nvar har ɵtɑːn ɔtɧɪllnad rɛtt tiːll lɪka lœn føːr lɪka arbɛteː
human_rights_un_swe_adam_64kb_0081	nvar suːm ɑːrbeːtɑːr har rɛtt tiːll rɛːttviːs uːɧ tɪllfrɛdsstɛːllandeː ɛrsɛttnɪŋ suːm tiːllfœrsɛːkrar hɔnuːm ɧɛlv uːɧ hans famiːj eːn mɛːnnɪɧuːvɛːrdiːɡ tɪllvɑːruː uːɧ suːm dɛr soː ɛr nøːdvɛndɪjt ɕɔmplɛtteːrɑːs meːd andrɑː mɛdeːl føːr sɔsɪɑːlt ɧyːdd
human_rights_un_swe_adam_64kb_0082	nvar har rɛtt att biːldɑː uːɧ anslɵtɑː siːɡ tiːll fakføːreːnɪŋar tiːll ɧyːdd føːr sɪna iːntreːssɛn
human_rights_un_swe_adam_64kb_0083	rtiːkɛl
human_rights_un_swe_adam_64kb_0084	nvar har rɛtt tiːll vɪla uːɧ friːtɪd iːnneːfɑːttandeː riːmlɪɡ bɛŋrɛnsnɪŋ av ɑːrbeːtstɪdeːn uːɧ reːjɛlbɵndeːn seːmɛsteːr meːd bɪbeːhoːllɛn lœn
human_rights_un_swe_adam_64kb_0085	rtiːkɛl
human_rights_un_swe_adam_64kb_0086	nvar har rɛtt tiːll eːn lɛvnɑːdsstɑːndɑːrd suːm ɛr tɪllrɛklɪɡ føːr hans eːjeːn uːɧ hans famiːjs hɛlsɑː uːɧ vɛlbɛfɪnnɑːndeː dɛːriː ɪnbɛɡrɪpɛt fœda ɕlɛdɛr bɔstad hɛlsuːvɔrd uːɧ nœdvɛndiːŋɑː sɔsiːalɑː fœrmɔnɛr viːdɑːrɛ rɛtt tiːll tryːŋŋheːt ɪ hɛndɛlseː av ɑːrbeːtslœɧeːt ɧʉːkduːm iːnvɑːliːdiːteːt mɑːkeːs døːd ɔldeːrduːm ɛlleːr annɑːn fœrlɵst av fœrsœrjniːŋ ʉːndeːr uːmstɛːndiːjheːtɛr œveːr vɪlka hɑːn iːkɛ ɕʉːnnɑːt rɔda
human_rights_un_swe_adam_64kb_0087	œdrar uːɧ bɑːrn ɛːruː beːrɛːttɪjadeː tiːll sɛːrɧiːld ɔmvoːrdnad uːɧ jɛlp
human_rights_un_swe_adam_64kb_0088	lla bɑːrn vɑːreː siːɡ føːddɑː ɪnuːm ɛlleːr ʉːtuːm ɛːktɛnɧap ɧuːla oːtnjɵtɑː sɑːmma sɔsiːalɑː ɧyːdd
human_rights_un_swe_adam_64kb_0089	rtiːkɛl
human_rights_un_swe_adam_64kb_0090	nvar har rɛtt tiːll ʉːndɛrvɪsnɪŋ
human_rights_un_swe_adam_64kb_0091	ndɛrvɪsniːŋeːn ɧall vɑːra ɕɔstnɑːdsfrɪ oːtmiːnstɔneː poː deː eːleːmɛntɛːra uːɧ jrɵndlɛːjjandɛ stɑːdiːɛrna
human_rights_un_swe_adam_64kb_0092	eːn eːleːmɛntɛːra ɵndeːrvɪsnɪŋeːn ɧall vɑːra ɔbliːŋatɔrɪɧ
human_rights_un_swe_adam_64kb_0093	rkɛsʉːndɛrviːsnɪŋ uːɧ teːkniːɧ ʉːndɛrvɪsnɪŋ ɧall vɑːra ɑːllmɛnt tɪlljɛŋliːɡ
human_rights_un_swe_adam_64kb_0094	eːn hœŋrɛ ɵndeːrvɪsnɪŋeːn ɧall stoː øːppɛn ɪ lɪka mɔn føːr ɑːlla poː jrɵndvɑːl av deːrɑːs dʉːjlɪjhɛt
human_rights_un_swe_adam_64kb_0095	ndɛrvɪsniːŋeːn ɧall sʏfta tiːll pɛrsuːnliːŋhɛtɛns fʉːlla ɵtvɛkliːŋ uːɧ tiːll att stɛrka reːspɛktɛn føːr mɛːnniːɧɑːns jrɵndlɛːjjandɛ friː uːɧ rɛttiːjhɛtɛr
human_rights_un_swe_adam_64kb_0096	ndɛrvɪsniːŋeːn ɧall frɛːmja fœrstɔɛlseː tuːlɛrans uːɧ vɛnɧap meːllɑːn ɑːlla nɑːtɪɔneːr rasɡrɵppeːr uːɧ rɛlɪjiːœsɑː jrʉːppeːr samt beːfɔrdra œrɛnta ɑːtiːɔnɛrnɑːs vɛrksamhɛt føːr frɛdeːns bɛvarɑːndeː
human_rights_un_swe_adam_64kb_0097	ɛttɛn att vɛːja dɛn ʉːndɛrvɪsnɪŋ suːm ɧall jeːs oːt bɑːrnɛn tiːllkɔmmeːr ɪ frɛːmsta rɵmmɛt deːrɑːs føːrɛːldrar
human_rights_un_swe_adam_64kb_0098	rtiːkɛl
human_rights_un_swe_adam_64kb_0099	nvar har rɛtt att friːtt tɑːŋɑː deːl ɪ samhɛːllɛts ɕʉːltʉːreːlla liːv att njʉːta av ɕuːnstɛn samt att bliː dɛlaktiːɡ av veːteːnɧɑːpeːns frɑːmsteːɡ uːɧ deːss fœrmɔnɛr
human_rights_un_swe_adam_64kb_0100	nvar har rɛtt tiːll ɧyːdd føːr deː mɔraliːɧa uːɧ mateːrɪɛllɑː iːntreːssɛn suːm hɛrrøːrɑː frɔn vɑːrjeː veːtɛnɧɑːplɪŋt liːtteːrɛːrt ɛlleːr ɕɔnstnɛːrliːɡt veːrk tiːll vɪlkeːt hɑːn ɛr ʉːpphuːvsman
human_rights_un_swe_adam_64kb_0101	rtiːkɛl
human_rights_un_swe_adam_64kb_0102	nvar har rɛtt tiːll eːn suːsɪɑːl uːɧ iːntɛrnɑːtɪɔnɛll uːrdniːŋ ɪ viːlkeːn deː friː uːɧ rɛttiːjhɛtɛr suːm ʉːttalɑːs ɪ deːnnɑː føːrklɑːrɪŋ tiːll fʉːlluː ɕʉːnnɑː fœrvɛrklɪɡas
human_rights_un_swe_adam_64kb_0103	rtiːkɛl
human_rights_un_swe_adam_64kb_0104	nvar har plɪkteːr muːt samhɛːlleːt ɪ vɪlkeːt dɛn frɪa uːɧ fɵllstɛndiːŋa ɵtveːkliːŋɛn av hans peːrsɔnliːŋheːt ɛnsamt ɛr møːjlɪɡ
human_rights_un_swe_adam_64kb_0105	iːd ʉːtøːvɑːndeːt av sɪna friː uːɧ rɛttiːjhɛtɛr moː ɛnvar ɵndɛrkastas ɛndast sɔdana iːnɧrɛnkniːŋar suːm bliːvɪt fɑːststɛllda ɪ laɡ ɪ ʉːteːslʉːtɑːndɛ sʏfteː att trʏjŋa tiːllbœrliːɡ hɛnsʏn tiːll uːɧ reːspɛkt føːr ɑːndras friː uːɧ rɛttiːjhɛtɛr samt føːr att tɪllɡɔdɔsɛ deːt deːmuːkratiːɧɑː samhɛːllɛts rɛttmɛtɪja ɕrav poː mɔral ɑːllmɛːn uːrdniːŋ uːɧ ɑːllmɛːn vɛlfɛːrd
human_rights_un_swe_adam_64kb_0106	ɛssa friː uːɧ rɛttiːjhɛtɛr moː ɪ ɪnteːt fall ɵtœvɑːs ɪ striːd meːd œrɛnta ɑːtiːɔnɛrnɑːs ɛːndamɔl uːɧ jrʉːndsatsɛr
human_rights_un_swe_adam_64kb_0107	rtiːkɛl
human_rights_un_swe_adam_64kb_0108	nteːt ɪ deːnnɑː føːrklɑːrɪŋ moː tɔlkas sɔsuːm ɪnneːbɛrandɛ rɛːttiːjhɛt føːr noːjuːn stat jrɵpp ɛlleːr peːrsɔn att ɛːŋna siːɡ oːt vɛrksamhɛt ɛlleːr ɵtføːra handliːŋ suːm sʏftar tiːll att ɔmiːnteːtjøːra noːjuːn av hɛːriː ʉːttɑːladɛ friː uːɧ rɛttiːjhɛtɛr
