human_rights_un_spa_mr_64kb_0001	deklaɾasion uniβeɾsal de deɾecos wmanos
human_rights_un_spa_mr_64kb_0002	aðoptaða j pɾoklamaða poɾ la asamblea xeneɾal en su resolusion esk a i de a de disiembɾe de
human_rights_un_spa_mr_64kb_0003	pɾeambulo
human_rights_un_spa_mr_64kb_0004	konsiðeɾando ke la liβeɾtað la xustisia j la pas en el mundo tienen poɾ base el rekonosimiento de la digniðað intɾinseka j de los deɾecos iɣuales e inalienaβles de toðos los miembɾos de la familia wmana
human_rights_un_spa_mr_64kb_0005	konsiðeɾando ke el deskonosimiento j el menospɾesio de los deɾecos wmanos an oɾixinaðo aktos de baɾβaɾie ultɾaxantes paɾa la konsiensia de la wmaniðað
human_rights_un_spa_mr_64kb_0006	j ke se a pɾoklamaðo komo la aspiɾasion mas eleβaða del ombɾe el aðβenimiento de un mundo en ke los seɾes wmanos liβeɾaðos del temoɾ j de la miseɾia disfɾuten de la liβeɾtað de palaβɾa j de la liβeɾtað de kɾensias
human_rights_un_spa_mr_64kb_0007	konsiðeɾando esensial ke los deɾecos wmanos sean pɾotexiðos poɾ un reximen de deɾeco a fin de ke el ombɾe no se bea kompeliðo al supɾemo rekuɾso de la reβelion kontɾa la tiɾania j la opɾesion
human_rights_un_spa_mr_64kb_0008	konsiðeɾando tambien esensial pɾomoβeɾ el desaroʎo de relasiones amistosas entɾe las nasiones
human_rights_un_spa_mr_64kb_0009	konsiðeɾando ke los pueβlos de las nasiones uniðas an reafiɾmaðo en la kaɾta su fe en los deɾecos fundamentales del ombɾe en la digniðað j el baloɾ de la peɾsona wmana j en la iɣualdað de deɾecos de ombɾes j muxeɾes
human_rights_un_spa_mr_64kb_0010	j se an deklaɾaðo resueltos a pɾomoβeɾ el pɾogɾeso sosial j a eleβaɾ el niβel de biða dentɾo de un konsepto mas amplio de la liβeɾtað
human_rights_un_spa_mr_64kb_0011	konsiðeɾando ke los estaðos miembɾos se an kompɾometiðo a aseguɾaɾ en kopeɾasion kon la oɾganisasion de las nasiones uniðas el respeto uniβeɾsal j efektiβo a los deɾecos j liβeɾtaðes fundamentales del ombɾe j
human_rights_un_spa_mr_64kb_0012	konsiðeɾando ke una konsepsion komun de estos deɾecos j liβeɾtaðes es de la majoɾ impoɾtansia paɾa el pleno kumplimiento de dico kompɾomiso
human_rights_un_spa_mr_64kb_0013	la asamblea xeneɾal
human_rights_un_spa_mr_64kb_0014	pɾoklama la pɾesente deklaɾasion uniβeɾsal de deɾecos wmanos komo iðeal komun poɾ el ke toðos los pueβlos j nasiones deβen esfoɾsaɾse a fin de ke tanto los indiβiðuos komo las institusiones inspiɾandose konstantemente en eʎa pɾomueβan meðiante la enseɲansa j la eðukasion el respeto a estos deɾecos j liβeɾtaðes j aseguɾen poɾ meðiðas pɾogɾesiβas de kaɾakteɾ nasional e inteɾnasional su rekonosimiento j aplikasion uniβeɾsales j efektiβos tanto entɾe los pueβlos de los estaðos miembɾos komo entɾe los de los teritoɾios kolokaðos baxo su xuɾizðiksion
human_rights_un_spa_mr_64kb_0015	aɾtikulo
human_rights_un_spa_mr_64kb_0016	toðos los seɾes wmanos nasen liβɾes e iɣuales en digniðað j deɾecos j dotaðos komo estan de rason j konsiensia deβen kompoɾtaɾse fɾateɾnalmente los unos kon los otɾos
human_rights_un_spa_mr_64kb_0017	aɾtikulo s
human_rights_un_spa_mr_64kb_0018	toða peɾsona tiene los deɾecos j liβeɾtaðes pɾoklamaðos en esta deklaɾasion sin distinsion alguna de rasa koloɾ sekso iðioma relixion opinion politika o de kualkieɾ otɾa indole oɾixen nasional o sosial posision ekonomika nasimiento o kualkieɾ otɾa kondision
human_rights_un_spa_mr_64kb_0019	aðemas no se aɾa distinsion alguna fundaða en la kondision politika xuɾiðika o inteɾnasional del pais o teritoɾio de kuja xuɾizðiksion dependa una peɾsona tanto si se tɾata de un pais independiente komo de un teritoɾio baxo aðministɾasion fiðusiaɾia no autonomo o sometiðo a kualkieɾ otɾa limitasion de soβeɾania
human_rights_un_spa_mr_64kb_0020	aɾtikulo
human_rights_un_spa_mr_64kb_0021	toðo indiβiðuo tiene deɾeco a la biða a la liβeɾtað j a la seguɾiðað de su peɾsona
human_rights_un_spa_mr_64kb_0022	aɾtikulo
human_rights_un_spa_mr_64kb_0023	naðie estaɾa sometiðo a esklaβituð ni a seɾβiðumbɾe
human_rights_un_spa_mr_64kb_0024	la esklaβituð j la tɾata de esklaβos estan pɾojβiðas en toðas sus foɾmas
human_rights_un_spa_mr_64kb_0025	aɾtikulo
human_rights_un_spa_mr_64kb_0026	naðie seɾa sometiðo a toɾtuɾas ni a penas o tɾatos kɾueles inwmanos o degɾaðantes
human_rights_un_spa_mr_64kb_0027	aɾtikulo
human_rights_un_spa_mr_64kb_0028	toðo seɾ wmano tiene deɾeco en toðas paɾtes al rekonosimiento de su peɾsonaliðað xuɾiðika
human_rights_un_spa_mr_64kb_0029	aɾtikulo sk
human_rights_un_spa_mr_64kb_0030	toðos son iɣuales ante la lej j tienen sin distinsion deɾeco a iɣual pɾoteksion de la lej
human_rights_un_spa_mr_64kb_0031	toðos tienen deɾeco a iɣual pɾoteksion kontɾa toða diskɾiminasion ke infɾinxa esta deklaɾasion j kontɾa toða pɾoβokasion a tal diskɾiminasion
human_rights_un_spa_mr_64kb_0032	aɾtikulo
human_rights_un_spa_mr_64kb_0033	toða peɾsona tiene deɾeco a un rekuɾso efektiβo ante los tɾiβunales nasionales kompetentes ke la ampaɾe kontɾa aktos ke biolen sus deɾecos fundamentales rekonosiðos poɾ la konstitusion o poɾ la lej
human_rights_un_spa_mr_64kb_0034	aɾtikulo
human_rights_un_spa_mr_64kb_0035	naðie poðɾa seɾ aɾβitɾaɾiamente deteniðo pɾeso ni desteraðo
human_rights_un_spa_mr_64kb_0036	aɾtikulo a
human_rights_un_spa_mr_64kb_0037	toða peɾsona tiene deɾeco en kondisiones de plena iɣualdað a seɾ oiða puβlikamente j kon xustisia poɾ un tɾiβunal independiente e impaɾsial paɾa la deteɾminasion de sus deɾecos j oβligasiones o paɾa el eksamen de kualkieɾ akusasion kontɾa eʎa en mateɾia penal
human_rights_un_spa_mr_64kb_0038	aɾtikulo
human_rights_un_spa_mr_64kb_0039	toða peɾsona akusaða de delito tiene deɾeco a ke se pɾesuma su inosensia mientɾas no se pɾueβe su kulpaβiliðað konfoɾme a la lej j en xuisio puβliko en el ke se le ajan aseguɾaðo toðas las gaɾantias nesesaɾias paɾa su defensa
human_rights_un_spa_mr_64kb_0040	naðie seɾa kondenaðo poɾ aktos u omisiones ke en el momento de kometeɾse no fueɾon deliktiβos segun el deɾeco nasional o inteɾnasional
human_rights_un_spa_mr_64kb_0041	tampoko se impondɾa pena mas gɾaβe ke la aplikaβle en el momento de la komision del delito
human_rights_un_spa_mr_64kb_0042	aɾtikulo s
human_rights_un_spa_mr_64kb_0043	naðie seɾa oβxeto de inxeɾensias aɾβitɾaɾias en su biða pɾiβaða su familia su domisilio o su korespondensia ni de atakes a su onra o a su reputasion
human_rights_un_spa_mr_64kb_0044	toða peɾsona tiene deɾeco a la pɾoteksion de la lej kontɾa tales inxeɾensias o atakes
human_rights_un_spa_mr_64kb_0045	aɾtikulo
human_rights_un_spa_mr_64kb_0046	toða peɾsona tiene deɾeco a siɾkulaɾ liβɾemente j a elexiɾ su resiðensia en el teritoɾio de un estaðo
human_rights_un_spa_mr_64kb_0047	toða peɾsona tiene deɾeco a saliɾ de kualkieɾ pas inkluso el pɾopio j a regɾesaɾ a su pais
human_rights_un_spa_mr_64kb_0048	aɾtikulo
human_rights_un_spa_mr_64kb_0049	en kaso de peɾsekusion toða peɾsona tiene deɾeco a buskaɾ asilo j a disfɾutaɾ de l en kualkieɾ pais
human_rights_un_spa_mr_64kb_0050	este deɾeco no poðɾa seɾ inbokaðo kontɾa una aksion xuðisial realmente oɾixinaða poɾ delitos komunes o poɾ aktos opuestos a los pɾopositos j pɾinsipios de las nasiones uniðas
human_rights_un_spa_mr_64kb_0051	aɾtikulo
human_rights_un_spa_mr_64kb_0052	toða peɾsona tiene deɾeco a una nasionaliðað
human_rights_un_spa_mr_64kb_0053	a naðie se pɾiβaɾa aɾβitɾaɾiamente de su nasionaliðað ni del deɾeco a kambiaɾ de nasionaliðað
human_rights_un_spa_mr_64kb_0054	aɾtikulo r
human_rights_un_spa_mr_64kb_0055	los ombɾes j las muxeɾes a paɾtiɾ de la eðað nuβil tienen deɾeco sin restɾiksion alguna poɾ motiβos de rasa nasionaliðað o relixion a kasaɾse j fundaɾ una familia
human_rights_un_spa_mr_64kb_0056	j disfɾutaɾan de iɣuales deɾecos en kuanto al matɾimonio duɾante el matɾimonio j en kaso de disolusion del matɾimonio
human_rights_un_spa_mr_64kb_0057	solo meðiante liβɾe j pleno konsentimiento de los futuɾos esposos poðɾa kontɾaeɾse el matɾimonio
human_rights_un_spa_mr_64kb_0058	la familia es el elemento natuɾal j fundamental de la sosieðað j tiene deɾeco a la pɾoteksion de la sosieðað j del estaðo
human_rights_un_spa_mr_64kb_0059	aɾtikulo sk
human_rights_un_spa_mr_64kb_0060	toða peɾsona tiene deɾeco a la pɾopieðað indiβiðual j kolektiβamente
human_rights_un_spa_mr_64kb_0061	naðie seɾa pɾiβaðo aɾβitɾaɾiamente de su pɾopieðað
human_rights_un_spa_mr_64kb_0062	aɾtikulo k
human_rights_un_spa_mr_64kb_0063	toða peɾsona tiene deɾeco a la liβeɾtað de pensamiento de konsiensia j de relixion
human_rights_un_spa_mr_64kb_0064	este deɾeco inkluje la liβeɾtað de kambiaɾ de relixion o de kɾensia asi komo la liβeɾtað de manifestaɾ su relixion o su kɾensia indiβiðual j kolektiβamente tanto en puβliko komo en pɾiβaðo poɾ la enseɲansa la pɾaktika el kulto j la oβseɾβansia
human_rights_un_spa_mr_64kb_0065	aɾtikulo
human_rights_un_spa_mr_64kb_0066	toðo indiβiðuo tiene deɾeco a la liβeɾtað de opinion j de ekspɾesion
human_rights_un_spa_mr_64kb_0067	este deɾeco inkluje el no seɾ molestaðo a kausa de sus opiniones el de inbestigaɾ j resiβiɾ infoɾmasiones j opiniones j el de difundiɾlas sin limitasion de fɾonteɾas poɾ kualkieɾ meðio de ekspɾesion
human_rights_un_spa_mr_64kb_0068	aɾtikulo e
human_rights_un_spa_mr_64kb_0069	toða peɾsona tiene deɾeco a la liβeɾtað de reunion j de asosiasion pasifikas
human_rights_un_spa_mr_64kb_0070	naðie poðɾa seɾ oβligaðo a peɾteneseɾ a una asosiasion
human_rights_un_spa_mr_64kb_0071	aɾtikulo e
human_rights_un_spa_mr_64kb_0072	toða peɾsona tiene deɾeco a paɾtisipaɾ en el goβieɾno de su pas diɾektamente o poɾ meðio de repɾesentantes liβɾemente eskoxiðos
human_rights_un_spa_mr_64kb_0073	toða peɾsona tiene el deɾeco de akseso en kondisiones de iɣualdað a las funsiones puβlikas de su pais
human_rights_un_spa_mr_64kb_0074	la boluntað del pueβlo es la base de la autoɾiðað del poðeɾ puβliko
human_rights_un_spa_mr_64kb_0075	esta boluntað se ekspɾesaɾa meðiante eleksiones autentikas ke aβɾan de seleβɾaɾse peɾioðikamente poɾ sufɾaxio uniβeɾsal e iɣual j poɾ boto sekɾeto u otɾo pɾoseðimiento ekiβalente ke gaɾantise la liβeɾtað del boto
human_rights_un_spa_mr_64kb_0076	aɾtikulo es
human_rights_un_spa_mr_64kb_0077	toða peɾsona komo miembɾo de la sosieðað tiene deɾeco a la seguɾiðað sosial j a oβteneɾ meðiante el esfueɾso nasional j la kopeɾasion inteɾnasional aβiða kuenta de la oɾganisasion j los rekuɾsos de kaða estaðo la satisfaksion de los deɾecos ekonomikos sosiales j kultuɾales indispensaβles a su digniðað j al liβɾe desaroʎo de su peɾsonaliðað
human_rights_un_spa_mr_64kb_0078	aɾtikulo e
human_rights_un_spa_mr_64kb_0079	toða peɾsona tiene deɾeco al tɾaβaxo a la liβɾe eleksion de su tɾaβaxo a kondisiones ekitatiβas j satisfaktoɾias de tɾaβaxo j a la pɾoteksion kontɾa el desempleo
human_rights_un_spa_mr_64kb_0080	toða peɾsonal tiene deɾeco sin diskɾiminasion alguna a iɣual salaɾio poɾ tɾaβaxo iɣual
human_rights_un_spa_mr_64kb_0081	toða peɾsona ke tɾaβaxa tiene deɾeco a una remuneɾasion ekitatiβa j satisfaktoɾia ke le aseguɾe asi komo a su familia una eksistensia konfoɾme a la digniðað wmana j ke seɾa kompletaða en kaso nesesaɾio poɾ kualeskieɾa otɾos meðios de pɾoteksion sosial
human_rights_un_spa_mr_64kb_0082	toða peɾsona tiene deɾeco a fundaɾ sindikatos j a sindikaɾse paɾa la defensa de sus inteɾeses
human_rights_un_spa_mr_64kb_0083	aɾtikulo e
human_rights_un_spa_mr_64kb_0084	toða peɾsona tiene deɾeco al deskanso al disfɾute del tiempo liβɾe a una limitasion rasonaβle de la duɾasion del tɾaβaxo j a bakasiones peɾioðikas pagaðas
human_rights_un_spa_mr_64kb_0085	aɾtikulo e
human_rights_un_spa_mr_64kb_0086	toða peɾsona tiene deɾeco a un niβel de biða aðekuaðo ke le aseguɾe asi komo a su familia la saluð j el bienestaɾ j en espesial la alimentasion el bestiðo la biβienda la asistensia meðika j los seɾβisios sosiales nesesaɾios
human_rights_un_spa_mr_64kb_0087	tiene asimizmo deɾeco a los seguɾos en kaso de desempleo enfeɾmeðað inbaliðes biuðes bexes j otɾos kasos de peɾðiða de sus meðios de suβsistensia poɾ siɾkunstansias independientes de su boluntað
human_rights_un_spa_mr_64kb_0088	la mateɾniðað j la infansia tienen deɾeco a kuiðaðos j asistensia espesiales
human_rights_un_spa_mr_64kb_0089	toðos los niɲos nasiðos de matɾimonio o fueɾa de matɾimonio tienen deɾeco a iɣual pɾoteksion sosial
human_rights_un_spa_mr_64kb_0090	aɾtikulo e
human_rights_un_spa_mr_64kb_0091	toða peɾsona tiene deɾeco a la eðukasion
human_rights_un_spa_mr_64kb_0092	la eðukasion deβe seɾ gɾatuita al menos en lo konseɾniente a la instɾuksion elemental j fundamental
human_rights_un_spa_mr_64kb_0093	la instɾuksion elemental seɾa oβligatoɾia
human_rights_un_spa_mr_64kb_0094	la instɾuksion tknika j pɾofesional aβɾa de seɾ xeneɾalisaða
human_rights_un_spa_mr_64kb_0095	el akseso a los estuðios supeɾioɾes seɾa iɣual paɾa toðos en funsion de los meɾitos respektiβos
human_rights_un_spa_mr_64kb_0096	la eðukasion tendɾa poɾ oβxeto el pleno desaroʎo de la peɾsonaliðað wmana j el foɾtalesimiento del respeto a los deɾecos wmanos j a las liβeɾtaðes fundamentales
human_rights_un_spa_mr_64kb_0097	faβoɾeseɾa la kompɾension la toleɾansia j la amistað entɾe toðas las nasiones j toðos los gɾupos etnikos o relixiosos
human_rights_un_spa_mr_64kb_0098	j pɾomoβeɾa el desaroʎo de las aktiβiðaðes de las nasiones uniðas paɾa el mantenimiento de la pas
human_rights_un_spa_mr_64kb_0099	los paðɾes tendɾan deɾeco pɾefeɾente a eskoxeɾ el tipo de eðukasion ke aβɾa de daɾse a sus jxos
human_rights_un_spa_mr_64kb_0100	aɾtikulo esk
human_rights_un_spa_mr_64kb_0101	toða peɾsona tiene deɾeco a tomaɾ paɾte liβɾemente en la biða kultuɾal de la komuniðað a gosaɾ de las aɾtes j a paɾtisipaɾ en el pɾogɾeso sientifiko j en los benefisios ke de el resulten
human_rights_un_spa_mr_64kb_0102	toða peɾsona tiene deɾeco a la pɾoteksion de los inteɾeses moɾales j mateɾiales ke le korespondan poɾ rason de las pɾoðuksiones sientifikas liteɾaɾias o aɾtistikas de ke sea autoɾa
human_rights_un_spa_mr_64kb_0103	aɾtikulo e
human_rights_un_spa_mr_64kb_0104	toða peɾsona tiene deɾeco a ke se estaβleska un oɾðen sosial e inteɾnasional en el ke los deɾecos j liβeɾtaðes pɾoklamaðos en esta deklaɾasion se agan plenamente efektiβos
human_rights_un_spa_mr_64kb_0105	aɾtikulo e
human_rights_un_spa_mr_64kb_0106	toða peɾsona tiene deβeɾes respekto a la komuniðað puesto ke solo en eʎa pueðe desaroʎaɾ liβɾe j plenamente su peɾsonaliðað
human_rights_un_spa_mr_64kb_0107	en el exeɾsisio de sus deɾecos j en el disfɾute de sus liβeɾtaðes toða peɾsona estaɾa solamente suxeta a las limitasiones estaβlesiðas poɾ la lej kon el uniko fin de aseguɾaɾ el rekonosimiento j el respeto de los deɾecos j liβeɾtaðes de los demas j de satisfaseɾ las xustas eksixensias de la moɾal del oɾðen puβliko j del bienestaɾ xeneɾal en una sosieðað demokɾatika
human_rights_un_spa_mr_64kb_0108	estos deɾecos j liβeɾtaðes no poðɾan en ningun kaso seɾ exeɾsiðos en oposision a los pɾopositos j pɾinsipios de las nasiones uniðas
human_rights_un_spa_mr_64kb_0109	aɾtikulo
human_rights_un_spa_mr_64kb_0110	naða en la pɾesente deklaɾasion poðɾa inteɾpɾetaɾse en el sentiðo de ke konfieɾe deɾeco alguno al estaðo a un gɾupo o a una peɾsona paɾa empɾendeɾ j desaroʎaɾ aktiβiðaðes o realisaɾ aktos tendientes a la supɾesion de kualkieɾa de los deɾecos j liβeɾtaðes pɾoklamaðos en esta deklaɾasion
