human_rights_un_afk_cdb_64kb_0001	ɑɑnhˈɛf
human_rights_un_afk_cdb_64kb_0002	ɑˈɑnɣzɪˈeːn ɛrkˈɛnɪŋ viːr dˈiː ɪnheːrˈɛntə ʋˈaːrdəxhɛɪt ˈɛn dˈiː xəlˈɪk ˈɛn ɔnvərvrˈeːmbaːrə rˈɛx vˈɑn ˈɑlə lˈeːdə vˈɑn dˈiː mɛnslɑjk rˈɑs dˈiː bˈaːzəs viːr vriːhɛɪt xərˈɛxtəxhɛɪt ˈɛn vrˈeːdə ˈɪn dˈiː ʋˈeːrəlt ˈɪs
human_rights_un_afk_cdb_64kb_0003	ɑˈɑnɣzɪˈeːn miːnədʒtɪŋ viːr mˈɛnsərˈɛxtə bɑrbˈaːrsə dˈaːdə ʋˈɑt dˈiː xəʋˈeːtə vˈɑn dˈiː mɛns ˈaːŋɣətɑs hɛt ˈɛn dˈiː ˈaːnvɑŋ vˈɑn n ʋˈeːrəlt ʋˈaːrɪn mˈɛnsə vriːhɛɪt vˈɑn sprˈaːk xəloːf vreːs ˈɛn bəhuːftə hɛt xəsˈiːn ʋˈɔrt ˈɑs dˈiː hˈoːxstə ɑspiːraːziː vˈɑn dˈiː xəmˈɪdəldə mɛns
human_rights_un_afk_cdb_64kb_0004	ɑˈɑnɣzɪˈeːn dɪt nˈoːtsaːklɪk ˈɪs dˈɑt mˈɛnsərˈɛxtə dˈøːr dˈiː ʋɛt bəskɛrm ʋˈɔrt tˈɛn ˈɛɪndə tə vˈoːrkɔm dˈɑt mˈɛnsə nˈiː xədʋˈɪŋ xˈaːn ʋˈɔrt ɔm ˈɪn ˈɔpstɑnt tˈeːn tiːrɑnˈiː ˈɛn ɔndərdrˈʉkɪŋ tə kɔm nˈiː
human_rights_un_afk_cdb_64kb_0005	ɑˈɑnɣzɪˈeːn dɪt nˈoːtsaːklɪk ˈɪs ɔm dˈiː ɔntʋɪkəlɪŋ vˈɑn vrˈiːndəlɑjk bˈɑndə tˈʉsə nˈaːsiːs ˈaːn tə mˈuːdəx
human_rights_un_afk_cdb_64kb_0006	ɑˈɑnɣzɪˈeːn dˈiː vˈɔlkə ʋˈɑt lˈɪt vˈɑn dˈiː vɛreːnəɣdə vˈɔlkə oːrɣaːniːsˈaːziː ˈɪs hˈʉl xəloːf ˈɪn fʉndaːmɛntˈeːlə mˈɛnsərˈɛxtə ˈɪn dˈiː hˈɑntfɛs bəklˈɛmtoːn ˈɪn dˈiː ʋˈaːrdəxhɛɪt ˈɛn ʋˈaːrdə vˈɑn dˈiː mɛnslɑjk pərsˈoːn ˈɪn dˈiː xəlˈɪk rˈɛxtə vˈɑn mˈɑns ˈɛn vrɯˈɛːs ˈɛn dɪt tˈɛn dˈuːl hɛt ɔm sˈoːziːjˈaːlə voːrˈœɪtxɑŋ ˈɛn n bˈeːtər leːʋəspɛɪl ˈɪn xrˈoːtər vriːhɛɪt tə bəvˈɔrdər
human_rights_un_afk_cdb_64kb_0007	ɑˈɑnɣzɪˈeːn ljtstˈaːtə hˈʉlə vˈoːrɣəneːm hɛt ɔm ˈɪn sˈaːməʋɛrkɪŋ mˈɛt dˈiː vɛreːnəɣdə vˈɔlkə yːniːvɛrzˈeːlə rɛspɛk ˈɛn aːɣtɪŋ viːr mˈɛnsərˈɛxtə ˈɛn fʉndaːmɛntˈeːlə vriːhɛɪt tə vərʋˈɛsəlɪk
human_rights_un_afk_cdb_64kb_0008	ˈɛn
human_rights_un_afk_cdb_64kb_0009	ɑˈɑnɣzɪˈeːn n ɑlɣəmˈeːnə bəɣrɪp vˈɑn hˈiːrdˈiː rˈɛxtə ˈɛn vriːheːdə vˈɑn xrˈoːt bəlˈɑŋ viːr dˈiː bərˈɛɪkɪŋ vˈɑn hˈiːrdˈiː vˈoːrneːmə ˈɪs
human_rights_un_afk_cdb_64kb_0010	vɛrklaːr dˈiː ɑlɣˈeːɛmˈeːnˈeː vˈeːrɣˈɑdˈeːrɪnɣ
human_rights_un_afk_cdb_64kb_0011	hˈiːrdˈiː ˈyːniːvɛrzˈeːlə vɛrklaːrɪŋ vˈɑn mˈɛnsərˈɛxtə ˈɑs n ɑlɣəmˈeːnə stˈɑndaːrt viːr dˈiː vərʋˈɛsəliːkɪŋ dˈøːr ˈɑlə mˈɛnsə ˈɛn nˈaːsiːs ɔm tə vərseːkər dˈɑt ˈɛlkə ɪndiːviːdˈyː ˈɛn ˈɛlkədeːl vˈɑn dˈiː xəmˈeːnskɑp hˈiːrdˈiː vɛrklaːrɪŋ ˈɪn ˈɑx sɑl nˈeːm ˈɛn dˈøːr ˈɔpfuːdɪŋ rɛspɛk viːr hˈiːrdˈiː rˈɛxtə ˈɛn vriːheːdə tə bəvˈɔrdər ˈɔp naːʃoːnˈaːlə ˈɛn ɪntərnaːʃoːnˈaːlə vlˈɑk daːrnaː sɑl strˈeːʋə ɔm dˈiː yːniːvɛrzˈeːlə ˈɛn ɛfˈɛksiːʋə ɛrkˈɛnɪŋ ˈɛn aːɣtɪŋ vˈɑn hˈiːrdˈiː rˈɛxtə tə vərseːkər nˈiː nˈɛt viːr dˈiː mˈɛnsə vˈɑn dˈiː ljtstˈaːtə nˈiː mˈaːr ˈoːk viːr dˈiː mˈɛnsə ˈɪn dˈiː xəbˈiːdə ˈɔndər hˈʉl jyːrəzdˈɪɡziː
human_rights_un_afk_cdb_64kb_0012	aːrtˈiːkəl
human_rights_un_afk_cdb_64kb_0013	ɑlə mɛnslɑjk ʋˈeːsɛns ʋˈɔrt vriː mˈɛt xəlˈɪk ʋˈaːrdəxhɛɪt ˈɛn rˈɛxtə xəbˈoːrə
human_rights_un_afk_cdb_64kb_0014	hˈʉlə hɛt reːdə ˈɛn xəʋˈeːtə ˈɛn bəhˈoːrt ˈɪn dˈiː xˈeːs vˈɑn brˈuːdərskɑp tˈeːnoːr mˈɛkaːr ˈɔp tə trˈeː
human_rights_un_afk_cdb_64kb_0015	aːrtˈiːkəl
human_rights_un_afk_cdb_64kb_0016	eːlkə pərsˈoːn hɛt dˈiː rˈɛx tɔt ɑl dˈiː rˈɛxtə ˈɛn vriːheːdə sˈoːs ˈɪn dˈiː vɛrklaːrɪŋ vərvˈɑt ˈɪs sɔndər ˈœɪtsɔndˈeːrɪŋ vˈɑn ˈeːnəɣə ˈaːrt sˈoːs ˈɔp xrˈɔnt vˈɑn rˈɑs xəslɑx klˈøːr tˈaːl xɔdzdˈiːns xəbˈoːrtə ˈɔf ˈeːnəɣə ˈɑndər stˈaːtʉs
human_rights_un_afk_cdb_64kb_0017	dˈaːrbeːnəʋɛns sɑl xˈeːn ˈɔndərskɛɪt ˈɔp xrˈɔnt vˈɑn poːliːtˈiːkə xərˈɛxteːlɑjk ˈɔf ɪntərnaːʃoːnˈaːlə stˈaːtʉs vˈɑn dˈiː lˈɑnt ˈɔf xəbˈiːt ʋaːrtˈuː n pərsˈoːn bəhˈoːrt xəmaːk ʋˈɔrt nˈiː hɛtsiː dɪt n ɔnɑfhˈɑŋklɑjk trˈʉst nˈiːsəlfrəɣeːrənt ˈɔf ˈɔndər ˈeːnəɣə ˈɑndər bəpˈɛrkɪŋ vˈɑn sˈuːʋərɛɪniːtˈɛɪt ˈɪs
human_rights_un_afk_cdb_64kb_0018	aːrtˈiːkəl
human_rights_un_afk_cdb_64kb_0019	eːlkeːn hɛt dˈiː rˈɛx tɔt leːʋə vriːhɛɪt ˈɛn sˈɛkyːriːtˈɛɪt vˈɑn pərsˈoːn
human_rights_un_afk_cdb_64kb_0020	aːrtˈiːkəl
human_rights_un_afk_cdb_64kb_0021	nˈiːmɑnt sɑl ˈɪn slˈaːʋˈʉrniː ˈɔf knˈɛxskɑp xəhɯ ʋˈɔrt nˈiː
human_rights_un_afk_cdb_64kb_0022	ˈɑlə vˈɔrms vˈɑn slˈaːʋˈʉrniː ˈɛn hˈɑndəl ˈɪn slˈaːʋə sɑl vərbˈiːt ʋˈɔrt
human_rights_un_afk_cdb_64kb_0023	aːrtˈiːkəl
human_rights_un_afk_cdb_64kb_0024	nˈiːmɑnt sɑl xəmˈɑrtəl ʋˈɔrt ˈɔf ˈaːn ʋrˈeːdə ɔnmɛnslɑjk ˈɔf vərnˈeːdərəndə bəhɑndəlɪŋ ˈɔf strˈɑf blˈoːtxəstɛl ʋˈɔrt nˈiː
human_rights_un_afk_cdb_64kb_0025	aːrtˈiːkəl
human_rights_un_afk_cdb_64kb_0026	eːlkeːn hɛt oːrˈɑl dˈiː rˈɛx tɔt ɛrkˈɛnɪŋ ˈɑs n pərsˈoːn vˈoːr dˈiː rˈɛx
human_rights_un_afk_cdb_64kb_0027	aːrtˈiːkəl
human_rights_un_afk_cdb_64kb_0028	ɑlmɑl ˈɪs xəlˈɪk vˈoːr dˈiː rˈɛx ˈɛn hɛt dˈiː rˈɛx tɔt xəlˈɪk bəskɛrmɪŋ vˈɑn dˈiː ʋɛt
human_rights_un_afk_cdb_64kb_0029	ɑlmɑl hɛt dˈiː rˈɛx tɔt xəlˈɪk bəskɛrmɪŋ tˈeːn ˈeːnəɣə dɪskrˈiːmiːnaːzˈiː tˈɛr skˈɛndɪŋ vˈɑn hˈiːrdˈiː vɛrklaːrɪŋ ˈɛn tˈeːn ˈeːnəɣə ˈaːnmuːdəɣɪŋ tɔt sˈʉlkə dɪskrˈiːmiːnaːzˈiː
human_rights_un_afk_cdb_64kb_0030	aːrtˈiːkəl
human_rights_un_afk_cdb_64kb_0031	eːlkeːn hɛt dˈiː rˈɛx tɔt ɛfˈɛksiːʋə kɔmpɛnzˈaːziː dˈøːr bəvˈuːɣdə naːʃoːnˈaːlə triːbyːnˈaːlə viːr dˈaːdə ʋˈɑt hˈʉl fʉndaːmɛntˈeːlə rˈɛx skˈaːt ʋˈɑt dˈøːr dˈiː ʋɛt ˈɔf xrˈɔndʋɛt ˈaːn hˈʉlə xəɣˈeː ˈɪs
human_rights_un_afk_cdb_64kb_0032	aːrtˈiːkəl
human_rights_un_afk_cdb_64kb_0033	nˈiːmɑnt sɑl ˈaːn ɑrbiːtrr ɑrəstˈaːziː ˈaːnhɯdɪŋ ˈɔf bˈɑnəlɪŋskɑp ɔndərʋˈɔrpə ʋˈeːs nˈiː
human_rights_un_afk_cdb_64kb_0034	aːrtˈiːkəl
human_rights_un_afk_cdb_64kb_0035	eːlkeːn hɛt ˈɪn vɔlə xəlˈɪkhɛɪt dˈiː rˈɛx tɔt n rˈɛxfərdəɣə ˈɛn oːpəbˈaːrə vərhˈoːr dˈøːr n ɔnɑfhˈɑŋklɑjk ˈɛn ɔbjˈɛksiːʋə triːbyːnaːl ˈɪn dˈiː bəpaːlɪŋ vˈɑn siː rˈɛxtə ˈɛn vərplˈɪxtɪŋə ˈɛn dˈiː ˈɔndərsuːk vˈɑn ˈeːnəɣə krˈiːmiːnˈeːlə sˈaːk tˈeːn hˈɔm
human_rights_un_afk_cdb_64kb_0036	aːrtˈiːkəl
human_rights_un_afk_cdb_64kb_0037	eːlkeːn bˈɛskˈʉldəx vˈɑn n strˈɑvbaːrə ˈoːrtreːdɪŋ hɛt dˈiː rˈɛx ɔm ˈɑs ɔnskˈʉldəx bˈɛskɯ tə ʋˈɔrt tɔt skˈʉldəx bəvˈɪnt vˈɔlɣəns dˈiː ʋɛt ˈɪn n oːpəbˈaːrə sˈaːk ʋˈaːrɪn hiː vərseːkər ˈɪs vˈɑn dˈiː nˈoːdəɣə vərdˈeːdəɣɪŋ
human_rights_un_afk_cdb_64kb_0038	nˈiːmɑnt sɑl bˈɛskˈʉldəx ʋˈɔrt vˈɑn n strˈɑvbaːrə ˈoːrtreːdɪŋ ˈɑs xəvˈɔlx vˈɑn ˈeːnəɣə dˈaːt ˈɔf naːlˈaːtəxhɛɪt ʋˈɑt vˈɔlɣəns naːʃoːnˈaːlə ˈɔf ɪntərnaːʃoːnˈaːlə ʋɛt nˈiː n mˈɪzdaːt tˈɛn tˈiːə vˈɑn dˈiː plˈeːx daːrvˈɑn ʋˈɑs nˈiː
human_rights_un_afk_cdb_64kb_0039	n sʋaːrdər strˈɑf sɑl ˈoːk nˈiː ˈɔpxəl ʋˈɔrt ˈɑs dˈiː strˈɑf ʋˈɑt tˈuːpɑslɪk ʋˈɑs tˈɛn tˈiːə vˈɑn dˈiː ˈoːrtreːdɪŋ nˈiː
human_rights_un_afk_cdb_64kb_0040	aːrtˈiːkəl
human_rights_un_afk_cdb_64kb_0041	nˈiːmɑnt sɑl ɔndərʋˈɔrpə ʋˈeːs ˈaːn ɑrbiːtrr ˈɪnmɛŋɪŋ mˈɛt siː priːvˈaːthɛɪt faːmˈiːliː ʋˈoːnɪŋ ˈɔf kɔrəspɔndɛnziː nˈiː ˈɔf ˈaːn ˈaːnvɑlə ˈɔp siː ˈeːr ˈɛn reːpyːtˈaːziː nˈiː
human_rights_un_afk_cdb_64kb_0042	eːlkeːn hɛt dˈiː rˈɛx tɔt bəskɛrmɪŋ dˈøːr dˈiː ʋɛt tˈeːn sˈʉlkə ˈɪnmɛŋɪŋ ˈɔf ˈaːnvɑlə
human_rights_un_afk_cdb_64kb_0043	aːrtˈiːkəl
human_rights_un_afk_cdb_64kb_0044	eːlkeːn hɛt dˈiː rˈɛx tɔt vriːhɛɪt vˈɑn bəʋˈeːɣɪŋ ˈɛn vərbliːf bˈɪnə dˈiː xrˈɛnsə vˈɑn ˈɛlkə stˈaːt
human_rights_un_afk_cdb_64kb_0045	eːlkeːn hɛt dˈiː rˈɛx ɔm ˈeːnəɣə lˈɑnt tə vərlaːt ˈɪnslœɪtəndə siː ˈɛɪjə ˈɛn nˈaː siː lˈɑnt tərˈʉx tə kˈeːr
human_rights_un_afk_cdb_64kb_0046	aːrtˈiːkəl
human_rights_un_afk_cdb_64kb_0047	eːlkeːn hɛt dˈiː rˈɛx tɔt aːzˈiːl ˈɪn ˈɑndər lˈɑndə
human_rights_un_afk_cdb_64kb_0048	daːr mˈɑx nˈiː ˈɔp hˈiːrdˈiː rˈɛx aːnspraːk xəmaːk ʋˈɔrt tˈiːdəns vərvˈɔlɣɪŋ viːr nˈiːpoːliːtiːkə ˈoːrtreːdɪŋs ˈɔf dˈaːdə ʋˈɑt strɪdəx ˈɪs mˈɛt dˈiː dˈuːlʋɪtə ˈɛn bəɣˈɪnsəls vˈɑn dˈiː vɛreːnəɣdə vˈɔlkə nˈiː
human_rights_un_afk_cdb_64kb_0049	aːrtˈiːkəl
human_rights_un_afk_cdb_64kb_0050	eːlkeːn hɛt dˈiː rˈɛx tɔt bˈʉrɣərskɑp
human_rights_un_afk_cdb_64kb_0051	nˈiːmɑnt sə bˈʉrɣərskɑp sɑl ɑrbiːtrr ˈɑfxəneːm ʋˈɔrt nˈiː ˈɛn nˈiːmɑnt sɑl vˈɑn dˈiː rˈɛx ɔntnˈeːm ʋˈɔrt ɔm ˈɑfstɑnt tə dˈuːn vˈɑn bˈʉrɣərskɑp nˈiː
human_rights_un_afk_cdb_64kb_0052	aːrtˈiːkəl
human_rights_un_afk_cdb_64kb_0053	vˈɔlʋɑsə mˈɑns ˈɛn vrɯˈɛːs sɔndər ˈeːnəɣə bəpˈɛrkɪŋ ˈɑs xəvˈɔlx vˈɑn rˈɑs nˈaːziːjoːnaːliːtˈɛɪt ˈɔf xɔdzdˈiːns hɛt dˈiː rˈɛx ɔm tə trɯ ˈɛn mˈɛt n faːmˈiːliː tə bəɣˈɪn
human_rights_un_afk_cdb_64kb_0054	hˈʉlə kˈɑn aːnspraːk mˈaːk ˈɔp xəlˈɪk rˈɛxtə tˈɛn ˈɔpsəxtə vˈɑn dˈiː hˈyːʋəlɪk tˈiːdəns dˈiː hˈyːʋəlɪk ˈɛn tˈiːdəns ɔndbˈɪndɪŋ vˈɑn dˈiː hˈyːʋəlɪk
human_rights_un_afk_cdb_64kb_0055	dˈiː hˈyːʋəlɪk sɑl plˈaːsfɪnt slˈɛxs mˈɛt dˈiː vriːʋˈɪləɣə ˈɛn vɔlə tˈuːstɛmɪŋ vˈɑn dˈiː vˈoːrneːməndə hˈyːʋəlɪksmaːts
human_rights_un_afk_cdb_64kb_0056	dˈiː faːmˈiːliː ˈɪs dˈiː naːtˈyːrlɑjk ˈɛn fʉndaːmɛntˈeːlə xrˈuːpseːnhɛɪt vˈɑn dˈiː xəmˈeːnskɑp ˈɛn kˈɑn aːnspraːk mˈaːk ˈɔp bəskɛrmɪŋ dˈøːr dˈiː xəmˈeːnskɑp ˈɛn dˈiː stˈaːt
human_rights_un_afk_cdb_64kb_0057	aːrtˈiːkəl
human_rights_un_afk_cdb_64kb_0058	eːlkeːn hɛt dˈiː rˈɛx ɔm ɪndiːviːdyːʋˈeːl ˈɛn ˈɪn ɑsoːziːjaːzˈiː mˈɛt ˈɑndər ˈɛɪjədɔm tə bəsɪt
human_rights_un_afk_cdb_64kb_0059	nˈiːmɑnt sə ˈɛɪjədɔm sɑl ɑrbiːtrr ˈɑfxəneːm ʋˈɔrt nˈiː
human_rights_un_afk_cdb_64kb_0060	aːrtˈiːkəl
human_rights_un_afk_cdb_64kb_0061	eːlkeːn hɛt dˈiː rˈɛx tɔt vriːhɛɪt vˈɑn dˈɛŋkə xəʋˈeːtə ˈɛn xɔdzdˈiːns
human_rights_un_afk_cdb_64kb_0062	hˈiːrdˈiː rˈɛx slˈœɪt ˈɪn dˈiː rˈɛx ɔm vˈɑn xɔdzdˈiːns ˈɔf xəloːf tə vərˈɑndər ˈɛn dˈiː vriːhɛɪt ɔm hɛtsiː ɑlˈeːn ˈɔf ˈɪn n xəmˈeːnskɑp hˈiːrdˈiː xɔdzdˈiːns ˈɔf xəloːf tə bəˈuːfə dˈøːr vərkˈɔndəɣɪŋ aːmbˈɪdɪŋ ˈɔf hˈɛɪləɣɪŋ
human_rights_un_afk_cdb_64kb_0063	aːrtˈiːkəl
human_rights_un_afk_cdb_64kb_0064	eːlkeːn hɛt dˈiː rˈɛx tɔt vriːhɛɪt vˈɑn oːpˈiːniː ˈɛn ˈœɪdrʉkɪŋ
human_rights_un_afk_cdb_64kb_0065	hˈiːrdˈiː rˈɛx slˈœɪt dˈiː vriːhɛɪt ˈɪn ɔm oːpˈiːniːs sɔndər ˈɪnmɛŋɪŋ tə lʉx ˈɛn ɔm ˈɪnlɪxtɪŋ ˈɛn iːdˈeːs tə vraː tə ɔntfˈɑŋ ˈɛn tə dˈeːl dˈøːr mɪdəl vˈɑn ˈeːnəɣə mˈeːdiːjʉm tˈɛn spɑjt vˈɑn xrˈɛnsə
human_rights_un_afk_cdb_64kb_0066	aːrtˈiːkəl
human_rights_un_afk_cdb_64kb_0067	eːlkeːn hɛt dˈiː rˈɛx tɔt vriːhɛɪt vˈɑn vrˈeːtsaːmə vərɣaːdərɪŋ ˈɛn ɑsoːziːjaːzˈiː
human_rights_un_afk_cdb_64kb_0068	nˈiːmɑnt sɑl xədʋˈɪŋ ʋˈɔrt ɔm ˈaːn n ɑsoːziːjaːzˈiː tə bəhˈoːrt nˈiː
human_rights_un_afk_cdb_64kb_0069	aːrtˈiːkəl
human_rights_un_afk_cdb_64kb_0070	eːlkeːn hɛt dˈiː rˈɛx ɔm ˈaːn dˈiː rəɣˈeːrɪŋ vˈɑn siː lˈɑnt dˈeːl tə nˈeːm hɛtsiː diːrɛk ˈɔf dˈøːr vriːlɪk vərkˈoːzə vərtˈeːnʋoːrdəɣərs
human_rights_un_afk_cdb_64kb_0071	eːlkeːn hɛt dˈiː rˈɛx tɔt xəlˈɪk tˈuːɣɑŋ tɔt dˈiː oːpəbˈaːrə dˈiːnstə ˈɪn siː lˈɑnt
human_rights_un_afk_cdb_64kb_0072	dˈiː ʋˈɪl vˈɑn dˈiː mˈɛnsə sɑl dˈiː bˈaːzəs vˈɔrm vˈɑn dˈiː ɯʋərhɛɪt ˈɔf rəɣˈeːrɪŋ ˈɛn hˈiːrdˈiː ʋˈɪl sɑl ˈœɪtxədrʉk ʋˈɔrt dˈøːr mɪdəl vˈɑn ˈɛxtə tˈʉsəvərkˈiːzɪŋs
human_rights_un_afk_cdb_64kb_0073	aːrtˈiːkəl
human_rights_un_afk_cdb_64kb_0074	eːlkeːn ˈɑs n lˈɪt vˈɑn dˈiː xəmˈeːnskɑp hɛt dˈiː rˈɛx tɔt bəstˈaːnseːkərhɛɪt ˈɛn kˈɑn aːnspraːk mˈaːk ˈɔp dˈiː vərʋˈɛsəliːkɪŋ vˈɑn dˈiː eːkoːnoːmˈiːsə sˈoːziːjˈaːlə ˈɛn kˈʉltyːrˈeːlə rˈɛxtə ʋˈɑt nˈoːtsaːklɪk ˈɪs viːr siː ʋˈaːrdəxhɛɪt ˈɛn dˈiː vrˈɑj ɔntʋɪkəlɪŋ vˈɑn siː pərsˈoːnlɪkhɛɪt dˈøːr mɪdəl vˈɑn naːʃoːnˈaːlə pˈoːɣɪŋs ˈɛn ɪntərnaːʃoːnˈaːlə sˈaːməʋɛrkɪŋ ˈɛn vˈɔlɣəns dˈiː ɔrɣaːniːzaːzˈiː ˈɛn hˈʉlbrˈɔnə vˈɑn ˈɛlkə stˈaːt
human_rights_un_afk_cdb_64kb_0075	aːrtˈiːkəl
human_rights_un_afk_cdb_64kb_0076	eːlkeːn hɛt dˈiː rˈɛx ɔm tə ʋˈɛrk tɔt dˈiː vrˈɑj kˈøːzə vˈɑn ˈɑrbɛɪt tɔt rˈɛxfərdəɣə ˈɛn xˈʉnstəɣə ʋˈɛrksɔmstɑndəxheːdə ˈɛn tɔt bəskɛrmɪŋ tˈeːn ʋɛrklˈoːshɛɪt
human_rights_un_afk_cdb_64kb_0077	eːlkeːn sɔndər dɪskrˈiːmiːnaːzˈiː hɛt dˈiː rˈɛx tɔt xəlˈɪk bətˈaːlɪŋ viːr xəlˈɪk ʋˈɛrk
human_rights_un_afk_cdb_64kb_0078	eːlkeːn ʋˈɑt ʋˈɛrk kˈɑn aːnspraːk mˈaːk ˈɔp rˈɛxfərdəɣə vərɣˈuːdɪŋ ʋˈɑt ˈaːn hˈɔm ˈɛn siː faːmˈiːliː n mɛnsʋˈaːrdəɣə bəstaːn vərseːkər ˈɛn ʋˈɑt ˈaːŋɣəvʉl kˈɑn ʋˈɔrt dˈøːr ˈɑndər vˈɔrms vˈɑn sˈoːziːjˈaːlə seːkərhɛɪt ˈɪndiːn nˈoːdəx
human_rights_un_afk_cdb_64kb_0079	eːlkeːn hɛt dˈiː rˈɛx tˈɛr bəskɛrmɪŋ vˈɑn siː bəlˈɑŋə ɔm vˈɑɡbɔndə tə stəx ˈɛn daːrbiː ˈaːn tə slˈœɪt
human_rights_un_afk_cdb_64kb_0080	aːrtˈiːkəl
human_rights_un_afk_cdb_64kb_0081	eːlkeːn hɛt dˈiː rˈɛx tɔt rˈʉs ˈɛn vrˈɑj tiːt ˈɪnslœɪtənt rˈeːdəlɑjk bəpˈɛrkɪŋs ˈɔp ʋˈɛrksˈyːrə ˈɛn peːriːjoːdˈiːkə bətˈaːldə vərlˈɔf
human_rights_un_afk_cdb_64kb_0082	aːrtˈiːkəl
human_rights_un_afk_cdb_64kb_0083	eːlkeːn hɛt dˈiː rˈɛx tɔt n leːʋəspɛɪl ʋˈɑt vɔldˈuːndə ˈɪs viːr xəsɔnthɛɪt ʋˈɛlsɪn viːr hˈɔmsɛlf ˈɛn siː faːmˈiːliː ˈɪnslœɪtəndə kˈɔs klˈeːrə bəhˈœɪsɪŋ meːdiːjˈeːzə sɔrx ˈɛn nˈoːtsaːklɑjk bəstˈaːnseːkərhɛɪt ˈɛn dˈiː rˈɛx tɔt vˈoːrdeːlə ˈɔf ˈɔndərstɑntsxɛlt tˈiːdəns ʋɛrklˈoːshɛɪt sˈiːktə ɔŋɣəskɪkthɛɪt ʋˈeːdyːʋˈeːskɑp ɯdˈərdɔm ˈɔf n təkɔrt ˈaːn leːʋəsmɪdələ tˈiːdəns ɔmstɑndəxheːdə bˈœɪtə siː bəhˈeːr
human_rights_un_afk_cdb_64kb_0084	mˈuːdərs ˈɛn kˈɪndərs kˈɑn aːnspraːk mˈaːk ˈɔp spˈeːsiːjˈaːlə sɔrx ˈɛn hˈʉlp
human_rights_un_afk_cdb_64kb_0085	ɑlə kˈɪndərs hɛtsiː bˈɪnə ˈɔf bˈœɪteːxteːlɪk sɑl dˈiːsəlvdə sˈoːziːjˈaːlə bəskɛrmɪŋ xənˈiːt
human_rights_un_afk_cdb_64kb_0086	aːrtˈiːkəl
human_rights_un_afk_cdb_64kb_0087	eːlkeːn hɛt dˈiː rˈɛx tɔt ˈɔpfuːdɪŋ
human_rights_un_afk_cdb_64kb_0088	ɔpfuːdɪŋ sɑl xrˈaːtəs ʋˈeːs tˈɛn mˈɪnstə ˈɪn dˈiː eːləmˈɛntrə ˈɛn fʉndaːmɛntˈeːlə stˈaːdiːjʉms
human_rights_un_afk_cdb_64kb_0089	eːləmˈɛntrə ˈɔpfuːdɪŋ sɑl vərplˈɪxtənt ʋˈeːs
human_rights_un_afk_cdb_64kb_0090	teːɣniːsə ˈɛn proːfɛʃoːnˈeːlə ˈɔpfuːdɪŋ sɑl xəreːdəlɪk bˈɛskˈɪɡbaːr ʋˈeːs ˈɛn hˈɔr ˈɔpfuːdɪŋ sɑl nˈɛt soː xəreːdəlɪk ˈɔp meːrˈiːtə bˈɛskˈɪɡbaːr ʋˈeːs
human_rights_un_afk_cdb_64kb_0091	ɔpfuːdɪŋ sɑl xəmɪk ʋˈeːs ˈɔp dˈiː vɔlə ɔntʋɪkəlɪŋ vˈɑn dˈiː mɛnslɑjk pərsˈoːnlɪkhɛɪt ˈɛn ˈɔp dˈiː bəvˈɔrdərɪŋ vˈɑn rɛspɛk viːr mˈɛnsərˈɛxtə ˈɛn fʉndaːmɛntˈeːlə vriːhɛɪt
human_rights_un_afk_cdb_64kb_0092	dˈɪt sɑl bəɣrɪp vərdrˈaːxsaːmhɛɪt ˈɛn vrˈiːntskɑp tˈʉsə ˈɑlə nˈaːsiːs rˈɑsə ˈɔf ɛtniːsə xrˈuːpə bəvˈɔrdər aːsˈoːk dˈiː ˈɑktiːʋiːtˈɛɪtə vˈɑn dˈiː vɛreːnəɣdə vˈɔlkə ˈɪn dˈiː hˈɑnthaːʋɪŋ vˈɑn vrˈeːdə
human_rights_un_afk_cdb_64kb_0093	ɯˈeːs hɛt dˈiː rˈɛx ɔm tə kˈiːs ʋˈɑtər tˈɪpə ˈɔpfuːdɪŋ hˈʉlə kˈɪndərs ɔntfˈɑŋ
human_rights_un_afk_cdb_64kb_0094	aːrtˈiːkəl
human_rights_un_afk_cdb_64kb_0095	ɑlmɑl hɛt dˈiː rˈɛx ɔm vriːlɪk ˈaːn dˈiː kˈʉltyːrˈeːlə leːʋə vˈɑn hˈʉl xəmˈeːnskɑp dˈeːl tə nˈeːm ɔm dˈiː kˈʉnstə tə xənˈiːt ˈɛn ˈɪn ʋˈeːtəskɑplɑjk voːrˈœɪtxɑŋ ˈɛn vˈoːrdeːlə tə dˈeːl
human_rights_un_afk_cdb_64kb_0096	eːlkeːn hɛt dˈiː rˈɛx tɔt dˈiː bəskɛrmɪŋ vˈɑn dˈiː moːrˈeːlə ˈɛn maːteːriːlə bəlˈɑŋə ʋˈɑt sprˈœɪt ˈœɪt ˈeːnəɣə ʋˈeːtəskɑplɑjk lɛtərkˈʉndəɣə ˈɔf kˈʉnsʋɛrk dˈøːr hˈɔm xəproːdyːzˈeːr
human_rights_un_afk_cdb_64kb_0097	aːrtˈiːkəl
human_rights_un_afk_cdb_64kb_0098	eːlkeːn ˈɪs xərˈɛxtəx ˈɔp n sˈoːziːjˈaːlə ˈɛn ɪntərnaːʃoːnˈaːlə ˈɔrdə ʋˈaːrɪn dˈiː rˈɛxtə ˈɛn vriːheːdə bˈɛskriːf ˈɪn hˈiːrdˈiː vɛrklaːrɪŋ tˈɛn vɔlə vərʋˈɛsəlɪk kˈɑn ʋˈɔrt
human_rights_un_afk_cdb_64kb_0099	aːrtˈiːkəl
human_rights_un_afk_cdb_64kb_0100	eːlkeːn hɛt vərplˈɪxtɪŋə tˈeːnoːr dˈiː xəmˈeːnskɑp ʋˈaːr ɑlˈeːnlɪk dˈiː vrˈɑj ˈɛn vɔlə ɔntʋɪkəlɪŋ vˈɑn siː pərsˈoːnlɪkhɛɪt mˈoːntlɪk ˈɪs
human_rights_un_afk_cdb_64kb_0101	ɪn dˈiː ˈœɪtuːfənɪŋ vˈɑn rˈɛxtə ˈɛn vriːheːdə sɑl ˈɛlkə mɛns slˈɛxs ɔndərʋˈɔrpə ʋˈeːs ˈaːn dˈiː ʋˈɛtlɑjk bəpˈɛrkɪŋə ˈɪŋɣəstɛl ɔm dˈeːɣlɑjk ɛrkˈɛnɪŋ ˈɛn rɛspɛk viːr dˈiː rˈɛxtə ˈɛn vriːheːdə vˈɑn ˈɑndər tə vərseːkər ˈɛn ɔm dˈiː rˈeːdəlɑjk vərˈɛɪstəs nˈaː tə kɔm viːr seːdəlˈɪkhɛɪt oːpəbˈaːrə ˈɔrdə ˈɛn dˈiː ɑlɣəmˈeːnə ʋˈɛlsɪn vˈɑn n deːmoːkraːtsiːsə xəmˈeːnskɑp
human_rights_un_afk_cdb_64kb_0102	hˈiːrdˈiː rˈɛxtə ˈɛn vriːheːdə mˈɑx ˈɪn xˈeːn xəvˈɑl strɪdəx mˈɛt dˈiː dˈuːlʋɪtə ˈɛn bəɣˈɪnsəls vˈɑn dˈiː vɛreːnəɣdə vˈɔlkə ˈœɪtxəuːfə ʋˈɔrt nˈiː
human_rights_un_afk_cdb_64kb_0103	aːrtˈiːkəl
human_rights_un_afk_cdb_64kb_0104	nˈɪks ˈɪn hˈiːrdˈiː vɛrklaːrɪŋ mˈɑx ɪntərpreːtˈeːr ʋˈɔrt ˈɑs ɪmpliːzˈeːrənt dˈɑt ˈeːnəɣə stˈaːt xruːp ˈɔf pərsˈoːn dˈiː rˈɛx hɛt ɔm dˈeːl tə nˈeːm ˈaːn ˈeːnəɣə ˈɑktiːʋiːtˈɛɪt ˈɔf ˈeːnəɣə dˈaːt ʋˈɑt xərəx ˈɪs ˈɔp dˈiː bɛskaːdəɣɪŋ vˈɑn ˈeːnəɣə rˈɛxtə ˈɛn vriːheːdə hˈiːrɪn bˈɛskriːf nˈiː
