human_rights_un_ind_rd_64kb_0001	ɛrɲətəən mum tentaŋ əkək sasɪ ənʊsea
human_rights_un_ind_rd_64kb_0002	ukədimah
human_rights_un_ind_rd_64kb_0003	ɪnimbaŋ bəhwa peŋakʊan ətəs mərtəbat ələmiəh dən haxək jaŋ səma dən motlak darɪ sɪmoa əŋɡota kɪloarɡə mənʊsɪə ədələh dəsar kɛmɛrdɪkaən kəədelan dən pərdamaian di dunɪa
human_rights_un_ind_rd_64kb_0004	ɪnimbaŋ bəhwa mɛŋabaikən dən məmandaŋ rɛndəh haxək asəse mənʊsɪə teləh meŋəkebətkan pɛrbuətənperbuatan bəŋɪs jaŋ mənɪmbulkan rəsa kəmərəhan hatɪ nurane ʊmət mənʊsɪə dən tɛrbɛntʊkɲa soatu dunɪa tɛmpət mənʊsɪə əkən mɛŋɛtʃəp kɛnekmatən kebɪbasan bɛrbitʃara dən bɛraɡama sərtə kebɪbasan darɪ kɪtakutən dən kɪkurəŋən teləh diɲətakən sɪbəɡai tʃɪtətʃɪtə tərteŋɡi darɪ rakjat beasə
human_rights_un_ind_rd_64kb_0005	ɪnimbaŋ bəhwa haxək asəse mənʊsɪə pɪrlʊ dilɪndʊŋe oləh pɪraturən hʊkʊm sʊpaja ʊraŋ tedak əkən tɪrpəksə mɪmelɪh pɛmbɛrʊntakan sɪbəɡai osahə teraxɪr ɡona mənɪntaŋ kɪlalimən dən pɛnendasən
human_rights_un_ind_rd_64kb_0006	ɪnimbaŋ bəhwa pəmbəŋonan hʊbʊŋan pɛrsahəbətan antərə nɛɡarəneɡarə pɪrlʊ deɡələkkan
human_rights_un_ind_rd_64kb_0007	ɪnimbaŋ bəhwa baŋsabaŋsə darɪ ərsɪrikatan əŋsaəŋsə sɛkale laɡɪ teləh mɛɲətakən di dəlam ɪaɡam ərsɪrikatan əŋsaəŋsə kɪpərtʃajaan mɛrəkə əkən haxək dəsar darɪ mənʊsɪə əkən mərtəbat dən nelai sɪsɛɔrəŋ mənʊsɪə dən əkən haxək jaŋ səma darɪ priə maupun wənɪta dən teləh bɪrtəkəd ontok məŋɡaləkkan kɪmədʒʊən sʊseəl dən təraf hɪdʊp jaŋ lebɪh baik di dəlam kɛmɛrdɪkaən jaŋ lebɪh loas
human_rights_un_ind_rd_64kb_0008	ɪnimbaŋ bəhwa ɪɡaraɪɡəra ŋɡʊtə teləh bɛrdʒandʒi ontok mɪntʃəpai kɪmədʒʊən dəlam peŋhərɡaan dən pɪnxɔrmatən omom terhadəp haxək asəse mənʊsɪə dən kəbɪbasənkɛbebasan asəse dɪŋən bɪkərdʒasama dɪŋən ərsɪrikatan əŋsaəŋsə
human_rights_un_ind_rd_64kb_0009	ɪnimbaŋ bəhwa pəŋɛrtɪan omom tentaŋ haxək dən kəbɪbasənkɛbebasan tɛrsɪbut saŋət pɛntiŋ ontok pɛlaksənəan jaŋ soŋɡohsoŋɡuh darɪ dʒandʒɪ ene məka
human_rights_un_ind_rd_64kb_0010	ədʒelis mum dɪŋən ene memprɔklaməsekan
human_rights_un_ind_rd_64kb_0011	ɛrɲətəən mum tentaŋ əkək sasɪ anʊsiasebaɡai satʊ standər omom kɛbɛrhaselan ontok sɪmoa bəŋsa dən sɪmoa nɪɡərə dɪŋən tʊdʒoən əɡər sətiəp ʊraŋ dən sətiəp bədan dəlam maʃarəkət dɪŋən senanteəsa məŋeŋat ɛrɲətəən ene əkən berosaha dɪŋən dʒəlan meŋadʒar dən mɛndɪdek ontok məŋɡaləkkan peŋhərɡaan terhadəp haxək dən kəbɪbasənkɛbebasan tɛrsɪbut dən dɪŋən dʒəlan tendakantendakan prɔɡrɪsif jaŋ bɪrsifat nəsɪonəl maupun entərnəsɪʊnal məndʒəmɪn peŋakʊan dən pɛŋhʊrmatanɲə sɪtʃərə ʊnɪvɪrsal dən ɪfektif baik oləh baŋsabaŋsə darɪ ɪɡaraɪɡəra ŋɡʊtə sɛndere maupun oləh baŋsabaŋsə darɪ dəerahdəərah jaŋ bɪrədə di bəwah kəkoəsəən hʊkʊm mɛrəkə
human_rights_un_ind_rd_64kb_0012	əsəl
human_rights_un_ind_rd_64kb_0013	əmʊə ʊraŋ dɪlahɪrkən merdɛka dən mɛmpʊɲai mərtəbat dən haxək jaŋ səma
human_rights_un_ind_rd_64kb_0014	erəkə dekaroneai əkəl dən hatɪ nurane dən hɛndəkɲə bərɡaul satʊ səma lain dəlam seməŋət pərsaudarəən
human_rights_un_ind_rd_64kb_0015	əsəl
human_rights_un_ind_rd_64kb_0016	ətɪəp ʊraŋ bɛrhək ətəs sɪmoa hək dən kəbɪbasənkɛbebasan jaŋ tɛrtʃantom di dəlam ɛrɲətəən ene tənpa pərketʃʊalɪan əpapʊn səpɛrti rəs wərna kʊlɪt dʒenɪs kɪlamen bahəsa əɡama pʊletik atau pendapət jaŋ bərlainan əsəl mola kəbaŋsəən atau kɛmaʃərakətən hək mɪlɪk kɪlahirən ataupun kɪdudʊkən lain
human_rights_un_ind_rd_64kb_0017	ɪ səmpeŋ eto tedak dipɪrbolehkən mɪlakukən perbɪdaan ətəs dəsar kɪdudʊkən pʊletik hʊkʊm atau kɪdudʊkən entərnəsɪʊnal darɪ nɪɡərə atau daɪrəh darɪ məna sɪsɛɔrəŋ berəsal baik darɪ nɪɡərə jaŋ merdɛka jaŋ bərbəntʊk wɪləjahwɪlajah pərwalɪan dʒədʒəhən atau jaŋ bɪrədə di bəwah bətəsən kədaulatən jaŋ lain
human_rights_un_ind_rd_64kb_0018	əsəl
human_rights_un_ind_rd_64kb_0019	ətɪəp ʊraŋ bɛrhək ətəs pɪŋhɪdupən kebɪbasan dən kɪsəlamatan indɪvɪdo
human_rights_un_ind_rd_64kb_0020	əsəl
human_rights_un_ind_rd_64kb_0021	ɪdək sɪɔrəŋ pun bʊləh dɪpərbʊdək atau depərhəmbəkan pɛrbudəkan dən pɛrdaɡəŋən bodak dəlam bəntʊk əpapʊn mɪstɪ dɪlaraŋ
human_rights_un_ind_rd_64kb_0022	əsəl
human_rights_un_ind_rd_64kb_0023	ɪdək sɪɔrəŋ pun bʊləh dɪsɪksə atau deperləkokan sɪtʃərə kedʒəm mɛmpərʊleh pərlakʊan atau dɪhokum sɪtʃərə tedak mənusiəwɪ atau dɪrendahkan mərtabatɲə
human_rights_un_ind_rd_64kb_0024	əsəl
human_rights_un_ind_rd_64kb_0025	ətɪəp ʊraŋ bɛrhək ətəs peŋakʊan di depən hʊkʊm sɪbəɡai pribəde di məna sədʒa ia bɪrədə
human_rights_un_ind_rd_64kb_0026	əsəl
human_rights_un_ind_rd_64kb_0027	əmʊə ʊraŋ səma di depən hʊkʊm dən bɛrhək ətəs perlɪndoŋan hʊkʊm jaŋ səma tənpa diskreminase
human_rights_un_ind_rd_64kb_0028	əmʊə bɛrhək ətəs perlɪndoŋan jaŋ səma terhadəp sətiəp bəntʊk diskreminase jaŋ bərtɛntəŋan dɪŋən ɛrɲətəən ene dən terhadəp sɪɡələ hasʊtən jaŋ meŋarah pəda diskreminase semətʃam eto
human_rights_un_ind_rd_64kb_0029	əsəl
human_rights_un_ind_rd_64kb_0030	ətɪəp ʊraŋ bɛrhək ətəs bantʊən jaŋ ɪfektif darɪ pəŋədilan nəsɪonəl jaŋ kɔmpətɪn ontok tɪndakən pɛləŋɡəran haxək dəsar jaŋ debɪrikən kɪpədəɲa oləh ondaŋundəŋ dəsar atau hʊkʊm
human_rights_un_ind_rd_64kb_0031	əsəl
human_rights_un_ind_rd_64kb_0032	ək sɪɔrəŋ pun bʊləh dɪtaŋkap detahən atau dɪbuəŋ dɪŋən səwenaŋwenəŋ
human_rights_un_ind_rd_64kb_0033	əsəl
human_rights_un_ind_rd_64kb_0034	ətɪəp ʊraŋ dəlam persəməən jaŋ penʊh bɛrhək ətəs pəŋədilan jaŋ adil dən tɛrbʊka oləh pəŋədilan jaŋ bebəs dən tedak məmihak dəlam mɛnɛtəpkan hək dən kɪwədʒɪbankɛwədʒebənɲə sərtə dəlam sətiəp tʊntutən pɪdana jaŋ dɪdʒatʊhkən kɪpədəɲa
human_rights_un_ind_rd_64kb_0035	əsəl
human_rights_un_ind_rd_64kb_0036	ətɪəp ʊraŋ jaŋ ditʊntʊt kərənə disəŋka mɪlakukən soatu pɛləŋɡəran hʊkʊm dɪaŋɡap tedak bersaləh sampai debuktikən kɛsalahənɲa mɪnorʊt hʊkʊm dəlam soatu pəŋədilan jaŋ tɛrbʊka di məna dea mɛmpərʊleh sɪmoa dʒamɪnən jaŋ dɪpərlʊkən ontok pɛmbɪlaənɲa
human_rights_un_ind_rd_64kb_0037	ɪdək sɪɔrəŋ pun bʊləh depərsələhkan mɪlakukən pɛləŋɡəran hʊkʊm kərənə pɪrboətən atau kɛlalaiən jaŋ tedak mɛropəkan soatu pɛləŋɡəran hʊkʊm mɪnorʊt ondaŋundəŋ nəsɪonəl atau entərnəsɪʊnal ketekə pɪrboətən tɛrsɪbut dɪlakʊkən
human_rights_un_ind_rd_64kb_0038	ʊɡə tedak dipɪrkɪnankən mɛndʒatʊhkən hʊkʊman lebɪh berət darepəda hʊkʊman jaŋ sehərusɲə dekenəkan ketekə pɛləŋɡəran hʊkʊm eto dɪlakʊkən
human_rights_un_ind_rd_64kb_0039	əsəl
human_rights_un_ind_rd_64kb_0040	ɪdək sɪɔrəŋ pun dəpat dɪɡəŋɡu dɪŋən səwenaŋwenəŋ ʊrosən prɪbədɪɲə kelʊərɡaɲə ruməhtaŋɡəɲə atau hʊbʊŋan surətməɲʊratɲə dʒoɡa tək dipɪrkɪnankən pɛləŋɡəran ətəs kəhormatanɲa dən nəma baikɲə
human_rights_un_ind_rd_64kb_0041	ətɪəp ʊraŋ bɛrhək mendapət perlɪndoŋan hʊkʊm terhadəp ɡəŋɡuan atau pɛləŋɡəran səpɛrti eto
human_rights_un_ind_rd_64kb_0042	əsəl
human_rights_un_ind_rd_64kb_0043	ətɪəp ʊraŋ bɛrhək ətəs kebɪbasan bɪrɡərək dən bɪrdiam di dəlam batasbətəs sətiəp nɪɡərə
human_rights_un_ind_rd_64kb_0044	ətɪəp ʊraŋ bɛrhək mɪniŋɡəlkan səsoətʊ neɡere tərməsʊk neɡerɪɲə sɛndere dən bɛrhək kəmbalɪ kɪ neɡerɪɲə
human_rights_un_ind_rd_64kb_0045	əsəl
human_rights_un_ind_rd_64kb_0046	ətɪəp ʊraŋ bɛrhək məntʃarɪ dən mɪnɪkməte soakə di neɡere lain ontok mɛlɪndoŋe dɪri darɪ peŋedʒarən
human_rights_un_ind_rd_64kb_0047	ək ene tedak bərlakʊ ontok kasus peŋedʒarən jaŋ bɛnarbenar tembʊl kərənə kedʒəhətənkɛdʒahətən jaŋ tək bərhubuŋən dɪŋən pʊletik atau kərənə pɛrbuətənperbuatan jaŋ bərtɛntəŋan dɪŋən tʊdʒoən dən dəsar ərsɪrikatan əŋsaəŋsə
human_rights_un_ind_rd_64kb_0048	əsəl
human_rights_un_ind_rd_64kb_0049	ətɪəp ʊraŋ bɛrhək ətəs səsoətʊ kɛwərɡənɛɡəraən
human_rights_un_ind_rd_64kb_0050	ɪdək sɪɔrəŋ pun dɪŋən sɛmenamɪnə dəpat dɪtʃəbʊt kɛwərɡanɛɡaraanɲa atau dɪtʊlak hakɲa ontok mɪŋɡənte kɛwərɡənɛɡəraən
human_rights_un_ind_rd_64kb_0051	əsəl
human_rights_un_ind_rd_64kb_0052	rea dən wənɪta jaŋ sodah dɪwəsə dɪŋən tedak dɪbatəsi kəbaŋsəən kɛwərɡənɛɡəraən atau əɡama bɛrhək ontok nekah dən ontok məmbəntʊk kɪloarɡə
human_rights_un_ind_rd_64kb_0053	erəkə mɛmpʊɲai hək jaŋ səma dəlam soal pɛrkawɪnən di dəlam məsa pɛrkawɪnən dən pəda səat pərtʃɛraiən
human_rights_un_ind_rd_64kb_0054	ərkawenan haɲə dəpat dɪləksənakan berdəsərkan pɪlɪhan bebəs dən pɛrsɛtodʒuən penʊh oləh kɪdoa mɪmpelai
human_rights_un_ind_rd_64kb_0055	ɛloarɡa ədələh kɪsətʊən ələmiəh dən fʊndamɛntəl darɪ maʃarəkət dən bɛrhək mendapət perlɪndoŋan darɪ maʃarəkət dən ɛɡarə
human_rights_un_ind_rd_64kb_0056	əsəl
human_rights_un_ind_rd_64kb_0057	ətɪəp ʊraŋ bɛrhək mɪmileke hərta baik sɛndere maupun bɛrsaməsəma dɪŋən ʊraŋ lain
human_rights_un_ind_rd_64kb_0058	ək sɪɔrəŋ pun bʊləh dirəmpas hərtəɲa dɪŋən sɛmenamɪnə
human_rights_un_ind_rd_64kb_0059	əsəl
human_rights_un_ind_rd_64kb_0060	ətɪəp ʊraŋ bɛrhək ətəs kebɪbasan pɪkɪran hatɪ nurane dən əɡama
human_rights_un_ind_rd_64kb_0061	dəlam həl ene tərməsʊk kebɪbasan bɛrɡanti əɡama atau kɪpərtʃajaan dən kebɪbasan ontok mɛɲətakən əɡama atau kɪpərtʃajaan dɪŋən tʃəra məŋadʒarkanɲa məmprəktɛkkənɲa mɛləksənəkan ibədəhɲa dən məntəateɲa baik sɛndere maupun bɛrsaməsəma dɪŋən ʊraŋ lain di moka omom maupun sɛndere
human_rights_un_ind_rd_64kb_0062	əsəl
human_rights_un_ind_rd_64kb_0063	ətɪəp ʊraŋ bɛrhək ətəs kebɪbasan mɛmpʊɲai dən məŋeluərkan pendapət
human_rights_un_ind_rd_64kb_0064	dəlam hək ene tərməsʊk kebɪbasan mɪmileke pendapət tənpa ɡəŋɡuan dən ontok məntʃarɪ mɪnɪremə dən mɪɲəmpaikan enfɔrmase dən boah pɪkɪran mɛlalʊe mɪdea əpə sədʒa dən dɪŋən tedak məmandaŋ batasbətəs welajəh
human_rights_un_ind_rd_64kb_0065	əsəl
human_rights_un_ind_rd_64kb_0066	ətɪəp ʊraŋ mɛmpʊɲai hək ətəs kebɪbasan berkumpul dən berserɪkat sɪtʃərə damai
human_rights_un_ind_rd_64kb_0067	ɪdək sɪɔrəŋ pun bʊləh dipaksə ontok mɛmasoke səsoətʊ pərkʊmpolən
human_rights_un_ind_rd_64kb_0068	əsəl
human_rights_un_ind_rd_64kb_0069	ətɪəp ʊraŋ bɛrhək tʊrʊt sərtə dəlam pɛmɛrintahan neɡerɪɲə sɪtʃərə laŋsoŋ atau mɛlalʊe wakilwakɪl jaŋ dɪpelih dɪŋən bebəs
human_rights_un_ind_rd_64kb_0070	ətɪəp ʊraŋ bɛrhək ətəs kɛsɛmpətan jaŋ səma ontok dɪaŋkat dəlam dʒəbətən pɛmɛrintahan neɡerɪɲə
human_rights_un_ind_rd_64kb_0071	ɪhəndak rakjat harus məndʒadɪ dəsar kəkoəsəən pemɛrɪntəh
human_rights_un_ind_rd_64kb_0072	kəhəndak ene harus diɲətakən dəlam pɪmilɪhən omom jaŋ dɪləksənakan sɪtʃərə bɪrkəla dən dʒʊdʒʊr dən jaŋ dɪlakʊkən mɪnorʊt hək pɪlɪh jaŋ bɪrsifat omom dən jaŋ tedak membedabɪdəkan dən dɪŋən pəmoŋutən soarə jaŋ rahasɪa ataupun mɪnorʊt tʃaratʃərə lain jaŋ məndʒəmɪn kebɪbasan memberɪkan soarə
human_rights_un_ind_rd_64kb_0073	əsəl
human_rights_un_ind_rd_64kb_0074	ətɪəp ʊraŋ sɪbəɡai əŋɡota maʃarəkət bɛrhək ətəs dʒamɪnən sʊseəl dən bɛrhək mɛləksənəkan dɪŋən pɛrantərəan usəhausahə nəsɪonəl dən kerdʒəsəma entərnəsɪʊnal dən səsoai dɪŋən orɡanɪsasi sərtə sombɛrsʊmbɪr kekəjaan darɪ sətiəp ɛɡarə haxək əkʊnʊmɪ sʊseəl dən kebodajəan jaŋ saŋət dɪpərlʊkən ontok mərtəbat dən pərtʊmbohən bebəs prɪbədɪɲə
human_rights_un_ind_rd_64kb_0075	əsəl
human_rights_un_ind_rd_64kb_0076	ətɪəp ʊraŋ bɛrhək ətəs pəkərdʒaan bɛrhək dɪŋən bebəs mɪmelɪh pəkərdʒaan bɛrhək ətəs ʃəratʃərat pərborohən jaŋ adil sərtə baik dən bɛrhək ətəs perlɪndoŋan darɪ pɪŋaŋɡʊrən
human_rights_un_ind_rd_64kb_0077	ətɪəp ʊraŋ tənpa diskreminase bɛrhək ətəs pɪŋʊpahan jaŋ səma ontok pəkərdʒaan jaŋ səma
human_rights_un_ind_rd_64kb_0078	ətɪəp ʊraŋ jaŋ mɪlakukən pəkərdʒaan bɛrhək ətəs pɪŋʊpahan jaŋ adil dən baik jaŋ məndʒəmɪn kɛhedupanɲa dən kelʊərɡaɲə soatu kɪhidʊpən jaŋ pantas ontok mənʊsɪə jaŋ bermartabat dən dʒeka pɪrlʊ ditəmbah dɪŋən perlɪndoŋan sʊseəl lainɲə
human_rights_un_ind_rd_64kb_0079	ətɪəp ʊraŋ bɛrhək mənderekən dən mɛmasoke sɛrekətsərɪkət pekərdʒa ontok mɛlɪndoŋe kɪpɪntiŋənɲə
human_rights_un_ind_rd_64kb_0080	əsəl
human_rights_un_ind_rd_64kb_0081	ətɪəp ʊraŋ bɛrhək ətəs ɪstirahət dən lɪbʊran tərməsʊk pɛmbətasanpɛmbətəsan dʒəm kərdʒə jaŋ ləjak dən harɪ lɪbʊr bɪrkəla dɪŋən mɪnɪremə ʊpəh
human_rights_un_ind_rd_64kb_0082	əsəl
human_rights_un_ind_rd_64kb_0083	ətɪəp ʊraŋ bɛrhək ətəs təraf hɪdʊp jaŋ məndʒəmɪn kesɪhatan dən kɛsɛdʒəhtɪrəan ontok dɪrɪɲa dən kelʊərɡaɲə tərməsʊk paŋən pakaian pɛroməhan dən pərəwətan kɛsəhatanɲə sərtə pələjənan sʊseəl jaŋ dɪpərlʊkən dən bɛrhək ətəs dʒamɪnən pəda səat mɛŋaŋɡor mɛndərita sakit tʃətʃat məndʒadɪ dʒənda mɪntʃəpai usea landʒut atau mɛŋaləme kɪkurəŋən məta pəntʃarɪan jaŋ lain kərənə kɛadaən jaŋ bɪrədə di loar kəkoasəanɲa
human_rights_un_ind_rd_64kb_0084	ərə ebo dən ənakanak bɛrhək mendapət pərəwətan dən bantʊən istɪmɪwə
human_rights_un_ind_rd_64kb_0085	əmʊə ənək baik jaŋ dɪlahɪrkən di dəlam maupun di loar pɛrkawɪnən harus mendapət perlɪndoŋan sʊseəl jaŋ səma
human_rights_un_ind_rd_64kb_0086	əsəl
human_rights_un_ind_rd_64kb_0087	ətɪəp ʊraŋ bɛrhək mendapət pəndedekən
human_rights_un_ind_rd_64kb_0088	ɛndidɪkən harus ɡratɪs setidaktɪdəkɲa ontok teŋkət səkɔlah rɛndəh dən pəndedekən dəsar
human_rights_un_ind_rd_64kb_0089	ɛndidɪkən rɛndəh harus dɪwadʒɪbkən
human_rights_un_ind_rd_64kb_0090	ɛndidɪkən təknɪk dən dʒʊrʊsan sɪtʃərə omom harus tɛrbʊka baɡɪ sɪmoa ʊraŋ dən pɛŋədʒarən tiŋɡe harus sɪtʃərə adil dəpat deəksɪs oləh sɪmoa ʊraŋ berdəsərkan kepantasan
human_rights_un_ind_rd_64kb_0091	ɛndidɪkən harus dɪtodʒokan kɪ ərəh pərkɛmbəŋan pribəde jaŋ selʊəsluəsɲə sərtə memperkʊkɔh rəsa peŋhərɡaan terhadəp haxək mənʊsɪə dən kebɪbasan asəse
human_rights_un_ind_rd_64kb_0092	ɛndidɪkən harus məŋɡaləkkan səleŋ pəŋɛrtɪan tʊlɪrənsɪ dən pɛrsahəbətan di antərə sɪmoa bəŋsa kɪlompɔk rəs maupun əɡama sərtə harus mɪmadʒukən kɪɡɪatən ərsɪrikatan əŋsaəŋsə dəlam mɛmelehərə pərdamaian
human_rights_un_ind_rd_64kb_0093	rəŋtua mɛmpʊɲai hək otamə ontok mɪmelɪh dʒenɪs pəndedekən jaŋ əkən debɪrikən kɪpədə ənakanak mɛrəkə
human_rights_un_ind_rd_64kb_0094	əsəl
human_rights_un_ind_rd_64kb_0095	ətɪəp ʊraŋ bɛrhək ontok tʊrʊt sərtə dɪŋən bebəs dəlam kɪhidʊpən kebodajəan maʃarəkət ontok mɛŋɛtʃəp kɛnekmatən kɛsəniən dən bərbaɡɪ dəlam kɪmədʒʊən elmo pɛŋɪtəhoən dən mənfəatɲə
human_rights_un_ind_rd_64kb_0096	ətɪəp ʊraŋ bɛrhək ontok mɛmpərʊleh perlɪndoŋan ətəs kɛpɪnteŋankepentɪŋan mʊrɪl dən matɪrɪəl jaŋ dɪperɔleh sɪbəɡai hasil darɪ səsoətʊ prɔdoksɪ ɪlmɪəh kɛsusəsterəən atau kɛsəniən jaŋ dɪtʃiptəkanɲə
human_rights_un_ind_rd_64kb_0097	əsəl
human_rights_un_ind_rd_64kb_0098	ətɪəp ʊraŋ bɛrhək ətəs soatu tətənən sʊseəl dən entərnəsɪʊnal di məna haxək dən kəbɪbasənkɛbebasan jaŋ tɛrmaktob di dəlam ɛrɲətəən ene dəpat dɪləksənakan səpənuhɲa
human_rights_un_ind_rd_64kb_0099	əsəl
human_rights_un_ind_rd_64kb_0100	ətɪəp ʊraŋ mɛmpʊɲai kɪwadʒibən terhadəp maʃarəkət tɛmpət satosatoɲa di məna ia mɛmpərʊleh kɛsɛmpətan ontok mɪŋembaŋkən prɪbədɪɲə dɪŋən penʊh dən leloəsa
human_rights_un_ind_rd_64kb_0101	ələm mendʒələnkan haxək dən kɛbəbasənkɪbɪbəsanɲa sətiəp ʊraŋ harus tondʊk haɲə pəda pɛmbətasanpɛmbətəsan jaŋ dɪtetapkan oləh ondaŋundəŋ dɪŋən maksud sɛmətəməta ontok məndʒəmɪn peŋakʊan sərtə pɪnxɔrmatən jaŋ ləjak terhadəp haxək dən kəbɪbasənkɛbebasan ʊraŋ lain dən ontok memenʊhɪ ʃəratʃərat jaŋ adil dəlam həl kesosiləən ketɛrtiban dən kɛsɛdʒəhtɪrəan omom dəlam soatu maʃarəkət jaŋ dəmʊkrates
human_rights_un_ind_rd_64kb_0102	əxak dən kəbɪbasənkɛbebasan ene dɪŋən dʒəlan bəɡaiməna pun sekalekəlɪ tedak bʊləh dɪləksənakan bərtɛntəŋan dɪŋən tʊdʒoən dən dəsar ərsɪrikatan əŋsaəŋsə
human_rights_un_ind_rd_64kb_0103	əsəl
human_rights_un_ind_rd_64kb_0104	ɪdək satʊ pun di dəlam ɛrɲətəən ene bʊləh dɪtafsɪrkən memberɪkan səsoətʊ ɛɡarə kɪlompɔk ataupun sɪsɛɔrəŋ hək ontok tɪrlibat di dəlam kɪɡɪatən əpə pun atau mɪlakukən pɪrboətən jaŋ bɪrtudʒoən ontok mərusak haxək dən kəbɪbasənkɛbebasan jaŋ məna pun jaŋ tɛrmaktob di dəlam ɛrɲətəən ene
