human_rights_un_slo_msed_64kb_0001	
human_rights_un_slo_msed_64kb_0002	vod
human_rights_un_slo_msed_64kb_0003	o vɛdomiː ʒɛ uzcaɲie prirodzɛcɛj ɟuostojŋosti a rovcix a cɛodtsudzitɛ ʎciːx praːv tʃlɛŋov ʎudskɛj roɟiɲi jɛ zaːkʎadom sʎobodi spravoɟlivosti a mieru ca svɛtɛʒɛ zɲɛuznaɲie ʎudskiːx praːv a poɦrɟacie cimi viedʎo k barbarskiːm tʃicom ktorɛː uraːʒajuː svɛdomie ʎudstva a ʒɛ vibuɟovaɲie svɛta v ktorom ʎuɟia zbavɛciː straxu a cuːdzɛ buduː sa tɛʃic sloboɟɛ prɛjavu a prɛsvɛɟtʃɛɲia bolo viɦlaːsɛcɛː za cajviʃʃiː tsieʎ ʎuduʒɛ jɛ cutcɛː abi sa ʎuɟsk praːva xraːɲili zaːkocom ak cɛmaː bic tʃlovɛk ɟoɲuːtɛiː uxiːlic sa kɛɟ vʃɛtko ostatcɛː zʎiɦalo k odboju proti tiracii a uːtlakuʒɛ jɛ cutcɛː podporovac rozvoj priatɛʎskiːx vzcaɦov mɛdzi caːrodmiʒɛ ʎud pojɛciːx ɲaːrodov zdorazcil v ɦartɛ zcovu svoju vieru v zaːkladcɛː ʎudskɛː praːva v ɟostojnosc a ɦodcotu ʎudskɛj osobcosti v rovcakɛː praːva muʒov a ʒien a ʒɛ sa rozɦodol podporovac sotsiaːʎci pokrok a vitvoric lɛpʃie ʒivotcɛː podmieŋki za vatʃʃɛj sloboɟiʒɛ tʃʎɛcskɛː ʃtaːti prɛvzali zaːvazok zaistic v spolupraːtsi s rɡacizaːtsiou pojɛiːx ɲaːrodov vʃɛobɛtscɛː uzŋaːvacie a zaxovaːvacie ʎudskiːx praːv a zaːklaɟiːiːx slobod aʒɛ rovcakɛː xaːpaɲie tiːxto praːv a slobod maː cɛsmierɲi viːzcam prɛ ɟokonalɛː spʎɲɛɲie toɦto zaːvazkuviɦlasujɛ
human_rights_un_slo_msed_64kb_0004	tuːto vʃɛobɛtscuː ɟɛklaraːtsiu ʎudskiːx praːv ako spolotʃciː tsieʎ prɛ vʃɛtki caːrodi a vʃɛtki ʃtaːti abi sa kaʒdiː jɛdnotlivɛts a kaʒdiː orɡaːn spoʎotʃcosti majuːts tuːto ɟɛklaraːtsiu staːlɛ ca misli scaʒil viutʃovaciːm a viːxovou rozʃiːric uːtstu k tiːmto praːvam a sloboɟaːm a zaistic postupciːmi opatrɛciami vcuːtroʃtaːtciːmi i mɛdzinaːroɟɲiːmi ix vʃɛobɛtscɛː a uːtʃicŋɛː uzŋaːvacie a zaxovaːvacie ako mɛdzi ʎudom tʃʎɛcskiːx ʃtaːtov samiːx tak mɛdzi ʎudom uːzɛmiː ktorɛː suː pod ix praːvomotsou
human_rights_un_slo_msed_64kb_0005	laːɲok
human_rights_un_slo_msed_64kb_0006	ʃɛttsi ʎuɟia sa roɟia sʎobodɲiː a sɛbɛ rovciː tʃo sa tiːka ix ɟostojŋosti a praːv
human_rights_un_slo_msed_64kb_0007	uː obdarɛciː rozumom a majuː cavzaːjom jɛdcac v bratskom ɟuxu
human_rights_un_slo_msed_64kb_0008	laːɲok
human_rights_un_slo_msed_64kb_0009	aʒdiː maː vʃɛtki praːva a vʃɛtki sʎobodi viɦlaːʃɛcɛː v tɛjto ɟɛkʎaraːtsii bɛz ɦotsiakɛːɦo rozʎiʃovaɲia cajma pod ʎa rasi farbi poɦlavia jazika caːboʒɛcstva polititskɛːɦo alɛbo icɛːɦo smiːʃʎacia caːroɟŋostcɛːɦo alɛbo sotsiaːlcɛːɦo povodu majɛtku rodu alɛbo icɛːɦo postavɛɲia
human_rights_un_slo_msed_64kb_0010	iaɟɛn rozɟiel sa ɲɛbuɟɛ robic ca poɟkʎaɟɛ polititskɛːɦo praːvcɛːɦo alɛbo ɲɛdziɲaːrodcɛːɦo postavɛɲia krajici alɛbo uːzɛmia ku ktorɛːmu osoba priː sluʃiː tʃi jɛ to krajica alɛbo uːzɛmie ɲɛzaːvislɛː alɛbo pod porutʃɛcstvom cɛsamospraːvɲɛ alɛbo poɟrobɛcɛː ɦotsiakɛːmu icɛːmu obmɛdzɛŋiu suvɛrɛciti
human_rights_un_slo_msed_64kb_0011	laːɲok
human_rights_un_slo_msed_64kb_0012	aʒdiː maː praːvo ca ʒivot sʎobodu a osobcuː bɛzpɛtʃcosc
human_rights_un_slo_msed_64kb_0013	laːɲok
human_rights_un_slo_msed_64kb_0014	ikto sa cɛsmie ɟrʒac v otrotstvɛ alɛbo v cɛvoʎciːtstvɛ vʃɛtki formi otrotstva a obxodu s otrokmi suː zakaːzacɛː
human_rights_un_slo_msed_64kb_0015	laːɲok
human_rights_un_slo_msed_64kb_0016	ikto cɛsmie bic mutʃɛciː alɛbo poɟrobɛciː krutɛːmu cɛʎudskɛːmu alɛbo pociʒujuːtsɛmu zaobxaːdzaniu alɛbo trɛstu
human_rights_un_slo_msed_64kb_0017	laːɲok
human_rights_un_slo_msed_64kb_0018	aʒdiː maː praːvo abi bola vʃaɟɛ uzcaːvacaː jɛɦo praːvca osobcosc
human_rights_un_slo_msed_64kb_0019	laːɲok
human_rights_un_slo_msed_64kb_0020	ʃɛttsi suː si prɛd zaːkocom rovciː a majuː praːvo ca rovcakuː oxraŋu zaːkoca bɛz ɦotsiakɛːɦo rozʎiʃovaɲia
human_rights_un_slo_msed_64kb_0021	ʃɛttsi majuː praːvo ca rovcakuː oxraŋu proti ɦotsiakɛj ɟiskrimiŋaːtsii ktoraː poruʃujɛ tuːto ɟɛklaraːtsiu a proti kaʒdɛːmu podɲtsovaɲiu k takɛj ɟiskrimiŋaːtsii
human_rights_un_slo_msed_64kb_0022	laːɲok
human_rights_un_slo_msed_64kb_0023	aʒdiː maː praːvo abi mu priːsʎuʃcɛː vcuːtroʃtaːtcɛ suːdi poskitli uːtʃicŋuː oxraŋu proti tʃicom poruʃujuːtsim ztʃkladcɛː praːva ktorɛː suː mu prizɲaːvaɲɛː uːstavou alɛbo zaːkocom
human_rights_un_slo_msed_64kb_0024	laːɲok
human_rights_un_slo_msed_64kb_0025	ikto cɛsmie bic svojvoʎcɛ zatkcutiː ɟrʒaɲiː vo vazbɛ alɛbo viɦɲaɲiː ɟo viɦɲacstva
human_rights_un_slo_msed_64kb_0026	laːɲok
human_rights_un_slo_msed_64kb_0027	aʒdiː maː uːplcɛ rovcakɛː praːvo abi bol spravodlivɛ a vɛrɛjcɛ vipotʃutiː cɛzaːvisliːm a cɛstraŋciːm suːdom ktoriː rozɦodujɛ o jɛɦo praːvax a poviɲcostiax a o kaʒdom trɛstcom obvicɛciː vzɲɛsɛnom proti cɛmu
human_rights_un_slo_msed_64kb_0028	laːɲok
human_rights_un_slo_msed_64kb_0029	aʒdiː kto jɛ obvicɛŋiː z trɛstcɛːɦo tʃicu povaʒujɛ sɛ za ɲɛviŋcɛːɦo ɟokiaʎ cie jɛ zaːkocŋiːm postupom ɟokaːzanaː jɛɦo vica vo vɛrɛjcom pokratʃovaciː pri ktorom mal zaistɛcɛː vʃɛtki moʒcosti obɦajobi
human_rights_un_slo_msed_64kb_0030	ikto cɛsmie bic odsuːɟɛciː prɛ tʃin alɛbo opomɛcutia ktorɛː v tʃasɛ kɛd boli spaːxanɛː cɛboli trɛstcɛː podʎa ʃtaːtcɛːɦo alɛbo mɛdzinaːroɟɲɛːɦo praːva
human_rights_un_slo_msed_64kb_0031	ovcako cɛsmie bic uloʒɛciː caʒʃiː trɛst cɛʒ trɛst ktoriː moɦol bic uloʒɛciː v tʃasɛ kɛ trɛstciː tʃin bol spaːxaniː
human_rights_un_slo_msed_64kb_0032	laːɲok
human_rights_un_slo_msed_64kb_0033	ikto cɛsmie bic vistavɛciː svojvoʎcɛːmu zasaɦovaɲiu ɟo suːkromcɛːɦo ʒivota roɟiɲi ɟomova alɛbo korɛʃpoŋɟɛctsie aci uːtokom ca svoju tʃɛsc a povɛsc
human_rights_un_slo_msed_64kb_0034	aʒdiː maː praːvo ca zaːkoɲcuː oxraŋu proti takiːmto zaːsaɦom alɛbo uːtokom
human_rights_un_slo_msed_64kb_0035	laːɲok
human_rights_un_slo_msed_64kb_0036	aʒdiː maː praːvo voʎcɛ sa poɦibovac a sʎobodɲɛ si zvolic bidʎisko v tom ktorom ʃtaːtɛ
human_rights_un_slo_msed_64kb_0037	aʒdiː maː praːvo opustic ɦotsiktoruː krajicu i svoju vlastcuː a vraːtic sa ɟo svojɛj krajici
human_rights_un_slo_msed_64kb_0038	laːɲok
human_rights_un_slo_msed_64kb_0039	aʒdiː maː praːvo viɦʎadac si prɛd prɛŋaslɛdovaciːm uːtotʃiʃtɛ v iciːx krajicaːx a poʒiːvac tam azil
human_rights_un_slo_msed_64kb_0040	oto praːvo cɛmoʒno uplatɲovac v priːpaɟɛ stiːɦaɲia ca ozaj oɟuovoɟcɛɲɛːɦo cɛpolititskiːmi zlotʃicmi alɛbo tʃicmi ktorɛː suː v rozporɛ s tsieʎami a zaːsadami pojɛciːx ɲaːrodov
human_rights_un_slo_msed_64kb_0041	laːɲok
human_rights_un_slo_msed_64kb_0042	aʒdiː maː praːvo ca ʃtaːtcu priːsluʃnosc
human_rights_un_slo_msed_64kb_0043	ikto cɛsmie bic svojvoʎcɛ zbavɛciː svojɛj ʃtaːtcɛj priːsluʃɲosti aci praːva svoju ʃtaːtcu priːsluʃnosc zmiecic
human_rights_un_slo_msed_64kb_0044	laːɲok
human_rights_un_slo_msed_64kb_0045	uʒi a ʒɛci ak ɟosiaɦli plnolɛtosc majuː praːvo bɛz ɦotsiakɛːɦo obmɛdzɛcia z ɟuovodov rasovɛj caːroɟŋostɛi alɛbo ɲaːboʒɛnskɛj priːsluʃɲosti uzavriec manʒɛlstvo a zaloʒic roɟiɲu
human_rights_un_slo_msed_64kb_0046	o sa manʒɛlstva tiːka majuː potʃas jɛɦo trvacia i pri jɛɦo rozluːtʃɛciː rovcakɛː praːva
human_rights_un_slo_msed_64kb_0047	anʒɛlstvaː muoʒu bic uzavrɛcɛː lɛn so sloboɟniːm a plciːm suːɦlasom castaːvajuːtsix maŋʒɛlov
human_rights_un_slo_msed_64kb_0048	oɟiɲa jɛ prirodzɛcou a zaːklaɟcou jɛɟcotkou spoʎotʃcosti a maː ɲaːrok ca oxraŋu so straci spoʎotʃcosti ʃtaːtu
human_rights_un_slo_msed_64kb_0049	laːɲok
human_rights_un_slo_msed_64kb_0050	aʒdiː maː praːvo vlastɲic majɛtok ako saːm tak spolu s iciːmi
human_rights_un_slo_msed_64kb_0051	ikto cɛsmie bic svojvoʎcɛ zbavɛciː svojɦo majɛtku
human_rights_un_slo_msed_64kb_0052	laːɲok
human_rights_un_slo_msed_64kb_0053	aʒdiː maː praːvo ca sʎobodu mislɛcia svɛdomia a caːboʒɛcstva
human_rights_un_slo_msed_64kb_0054	toto praːvo obsaɦujɛ aj voʎcosc zmɛcic caːboʒɛcstvo alɛbo vieru ako i sʎobodu prɛjavovac svojɛ caːboʒɛcstvo alɛbo vieru saːm alɛbo spolɛtʃɲɛ s iciːmi tʃi uʒ vɛrɛjcɛ alɛbo suːkromɲɛ viutʃovaciːm vikocaːvaciːm ɲaːboʒɛnskiːx uːkocov boɦosluʒbou a zaxovaːvaciːm obradov
human_rights_un_slo_msed_64kb_0055	laːɲok
human_rights_un_slo_msed_64kb_0056	aʒdiː maː praːvo ca sʎobodu prɛsvɛɟtʃɛɲia a prɛjavu toto praːvo cɛpripuːʃca abi ciekto trpɛl ujmu prɛ svojɛ prɛsvɛɟtʃɛɲie a zaɦrɲujɛ praːvo viɦʎadaːvac prijiːmac a rozʃirovac icformaːtsie a miʃʎieŋki ɦotsiakiːmi prostriedkami a bɛz oɦʎadu ca ɦracitsɛ
human_rights_un_slo_msed_64kb_0057	laːɲok
human_rights_un_slo_msed_64kb_0058	aʒdɛːmu jɛ zarutʃɛcaː sʎoboda pokojcɛːɦo sɦromaʒɟovaɲia a sɟruʒovaɲia sa
human_rights_un_slo_msed_64kb_0059	ikto cɛsmie bic cuːtɛciː abi bol tʃlɛŋom ɲɛjakɛːɦo sdruʒɛɲia
human_rights_un_slo_msed_64kb_0060	laːɲok
human_rights_un_slo_msed_64kb_0061	aʒdiː maː praːvo abi sa uːtʃastcil ca vʎaːɟɛ svojɛj krajici buɟ priamo alɛbo prostrɛɟɲiːtstvom sʎobodɲɛ volɛŋiːx zaːstuptsov
human_rights_un_slo_msed_64kb_0062	aʒdiː maː praːvo vstuːpic za rovcakiːx poɟmieɲok ɟo vɛrɛjciːx sluʒieb svojɛj krajici
human_rights_un_slo_msed_64kb_0063	uoʎa ʎudu maː bic zaːkʎadom vlaːɟcɛj motsi taːto vuoʎa musiː bic vijadrɛcaː spraːvcɛ prɛvaːdzaniːmi voʎbami ktorɛː sa majuː kocac v praviɟɛʎciːx obdobiax ca zaːklaɟɛ vʃɛobɛtscɛːɦo a rovcɛːɦo ɦlasovatsieɦo praːva tajciːm ɦlasovaciːm alɛbo rovɲotsɛcciːm postupom ktoriː zabɛzpɛtʃujɛ sʎobodu ɦʎasovaɲia
human_rights_un_slo_msed_64kb_0064	laːɲok
human_rights_un_slo_msed_64kb_0065	aʒdiː tʃlovɛk maː ako tʃlɛn spoʎotʃcosti praːvo ca sotsiaːlcɛ zabɛzpɛtʃɛɲie a ɲaːrok abi mu boli caːroɟniːm uːsiliːm i mɛdzinaːrodcou suːtʃiɲcoscou a v suːlaɟɛ s orɡacizaːtsiou a prostriedkami priːsluʃnɛːɦo ʃtaːtu zaistɛcɛː ɦospodaːrskɛ sotsiaːlcɛ a kultuːrɲɛ praːva potrɛbcɛː k jɛɦo ɟuostojŋosti a k sʎobodcɛːmu rozvoju jɛɦo osobcosti
human_rights_un_slo_msed_64kb_0066	laːɲok
human_rights_un_slo_msed_64kb_0067	aʒdiː maː praːvo ca praːtsu ca sʎobodɲuː voʎbu zamɛstcaɲia ca spravodlivɛː a uspokojivɛː pratsovcɛː podmieŋki a ca oxraŋu proti cɛzamɛstnaŋosti
human_rights_un_slo_msed_64kb_0068	aʒdiː bɛz ɦotsiakɛːɦo rozʎiʃovaɲia maː ɲaːrok ca rovcakiː plat za rovcakuː praːtsu
human_rights_un_slo_msed_64kb_0069	aʒdiː pratsujuːtsi maː praːvo ca spravodlivuː a ɟostatʃujuːtsu odmɛnu ktoraː bi zaiscovala jɛmu samɛːmu a jɛɦo roɟiɲɛ ʒivobitie oɟpovɛdajuːtsɛ ʎudskɛj ɟuostojŋosti a ktoraː bi bola ɟoplɲɛɲaː kɛbi toɦo bolo trɛba iciːmi prostriedkami sotsiaːʎcɛj oxraŋi
human_rights_un_slo_msed_64kb_0070	aʒdiː maː praːvo ca oxraŋu svojix zaːujmov zakʎadac s iciːmi odborovɛː orɡacizaːtsie a pristupovac k ciːm
human_rights_un_slo_msed_64kb_0071	laːɲok
human_rights_un_slo_msed_64kb_0072	aʒdiː maː praːvo ca oɟpotʃinok a ca zotavɛcie zvlaːʃc aj ca rozumcɛː vimɛdzɛcie pratsovŋiːx ɦoɟiːn a ca praviɟɛlnuː platɛcuː ɟovolɛŋku
human_rights_un_slo_msed_64kb_0073	laːɲok
human_rights_un_slo_msed_64kb_0074	aʒdiː maː praːvo ca takuː ʒivotcuː uːrovɛɲ ktoraː muoʒɛ zaistic jɛɦo zdravie a blaɦobit a zdravie jɛɦo roɟiɲi potʃiːtajuːts v to mɛcovitɛ viːʒivu ʃatɛcie biːvacie a lɛkaːrskɛ oʃɛtrovacie ako aj potrɛbcɛː sotsiaːlcɛ opatrɛcia maː praːvo ca zabɛzpɛtʃɛɲie v cɛzamɛstnaŋosti v cɛmotsi pri ɲɛsxopcosti k praːtsi pri ovdovɛciː v starobɛ alɛbo v iciːx priːpadox strati zaːrobkoviːx moʒcostiː ktorɛː castacuː za okolcostiː cɛzaːvisliːx cɛ jɛɦo vuoli
human_rights_un_slo_msed_64kb_0075	atɛrstvo a ɟɛtstvo majuː ɲaːrok ca zvʎaːʃtɲu strarostlivosc a pomots
human_rights_un_slo_msed_64kb_0076	ʃɛtki ɟɛti tʃi maŋʒɛlskɛː alɛbo ɲɛmacʒɛʎskɛː poʒiːvajuː rovcakuː sotsiaːʎcu oxraŋu
human_rights_un_slo_msed_64kb_0077	laːɲok
human_rights_un_slo_msed_64kb_0078	aʒdiː maː praːvo ca vzɟɛʎaɲie
human_rights_un_slo_msed_64kb_0079	zɟɛʎaɲie cɛx jɛ bɛzplatcɛː aspoɲ v zatʃiatotʃɲiːx a zaːkʎaɟciːx stupɲox
human_rights_un_slo_msed_64kb_0080	aːkʎadcɛː vzɟɛʎaɲie jɛ povicŋɛː
human_rights_un_slo_msed_64kb_0081	ɛxcitskɛː a odborcɛː vzɟɛʎaɲie cɛx jɛ vʃɛobɛtscɛ priːstupcɛː a viʃʃie vzɟɛʎaɲie maː bic rovcako priːstupcɛː kaʒdɛːmu podʎa jɛɦo sxopɲostiː
human_rights_un_slo_msed_64kb_0082	zɟɛʎaɲie maː smɛrovac k plŋɛːmu rozvoju ʎudskɛj osobcosti a k posiʎɲɛciu uːtsti k ʎudskiːm praːvam a zaːklaɟciːm sloboɟaːm
human_rights_un_slo_msed_64kb_0083	aː capomaːɦac k vzaːjomcɛːmu porozumɛŋiu scaːʃanlivosti a priatɛʎstvu mɛdzi vʃɛtkiːmi ɲaːrodmi a vʃɛtkiːmi rasoviːmi i ɲaːboʒɛnskiːmi skupicami ako aj k rozvoju tʃinŋosti pojɛciːx ɲaːrodov prɛ zaxovaɲie mieru
human_rights_un_slo_msed_64kb_0084	oɟitʃia majuː prɛdɲostcɛː praːvo volic ɟruɦ vzɟɛʎaɲia prɛ svojɛ ɟɛti
human_rights_un_slo_msed_64kb_0085	laːɲok
human_rights_un_slo_msed_64kb_0086	aʒdiː maː praːvo sʎobodɲɛ sa uːtʃastcic ca kuʎtuːrcom ʒivotɛ spoʎotʃcosti uʒiːvac ploɟov umɛcia a uːtʃastcic sa ca vɛɟɛtskom pokroku a jɛɦo viːcaʒkox
human_rights_un_slo_msed_64kb_0087	aʒdiː maː praːvo ca oxraŋu moraːʎcix a matɛriaːʎnix zaːujmov ktorɛː vipliːvajuː z jɛɦo vɛɟɛtskɛj litɛraːrcɛj alɛbo umɛlɛtskɛj tvorbi
human_rights_un_slo_msed_64kb_0088	laːɲok
human_rights_un_slo_msed_64kb_0089	aʒdiː maː praːvo ca to abi vlaːɟol takiː sotsiaːʎci a mɛdziŋaːroɟɲiː poriaɟok v ktorom bi praːva a sʎobodi viɦlaːsɛcɛː v tɛjto ɟɛkʎaraːtsii boli pʎɲɛ uplatɲɛɲɛː
human_rights_un_slo_msed_64kb_0090	laːɲok
human_rights_un_slo_msed_64kb_0091	aʒdiː maː poviɲŋosc votʃi spoʎotʃcosti jɛɟiɲɛ v cɛj muoʒɛ sʎobodɲɛ a pʎɲɛ rozvicuːc svoju osobcosc
human_rights_un_slo_msed_64kb_0092	o viːkocɛ svojix praːv a v uʒiːvaciː svojix slobuod jɛ kaʒdiː poɟrobɛciː iba takiːm obmɛdzɛciam ktorɛː stacoviː zaːkon a ktorɛː sluːʒia viːɦradcɛ k zabɛzpɛtʃɛciu caːlɛʒitɛːɦo uzŋaːvacia a zaxovaːvacia praːv a slobuod iciːx ako aj k uspokojɛniu spravodʎiviːx poʒiaɟaviek mravcosti vɛrɛjcɛːɦo poriadku a obɛtscɛːɦo blaɦa v ɟɛmokratiskɛj spoʎotʃcosti
human_rights_un_slo_msed_64kb_0093	iːkon tiːxto praːv a slobod cɛsmie bic v ʒiaɟcom priːpaɟɛ v rozporɛ s tsieʎami a zaːsadami pojɛciːx ɲaːrodov
human_rights_un_slo_msed_64kb_0094	laːɲok
human_rights_un_slo_msed_64kb_0095	tɛjto ɟɛkʎaraːtsii citʃ sa cɛsmie vikʎadac tak abi opraːvɲovalo ktoriːkoʎvɛk ʃtaːt skupicu alɛbo osobu viviːjac tʃicɲosc alɛbo ɟopuːʃcac sa tʃicov ktorɛː bi smɛrovali k potʎatʃɛciu ciektorɛːɦo z praːv alɛbo slobuod v tɛjto ɟɛkʎaraːtsii viɦʎaːsɛniːx
