human_rights_un_cat_nv_64kb_0001	aðoptaða i pɾoklamaða peɾ lasemblea xeneɾal de les nasions uniðes resolusjˈo esk a i de a de desembɾe de
human_rights_un_cat_nv_64kb_0002	deklaɾasjˈo uniβeɾsal de dɾets wmans
human_rights_un_cat_nv_64kb_0003	pɾembul
human_rights_un_cat_nv_64kb_0004	konsiðeɾant ke el rekoneiksement de la dignitat ineɾent i dels dɾets iɣuals i inalienaβles de tots els membɾes de la familia wmana es el fonament de la ʎiβeɾtat la xustisia i la pau en el mon
human_rights_un_cat_nv_64kb_0005	konsiðeɾant ke el deskoneiksement i el menjspɾeu dels dɾets wmans an oɾixinat aktes de baɾβaɾie ke an ultɾatxat la konsiensia de la wmanitat
human_rights_un_cat_nv_64kb_0006	i ke ʃa pɾoklamat koɱ laspiɾasjˈo mes eleβaða de totoɱ laðβeniment dun mon on els eseɾs wmans desʎiuɾats del temoɾ i la miseɾia puguin gauðiɾ de ʎiβeɾtat dekspɾesio i de kɾenka
human_rights_un_cat_nv_64kb_0007	konsiðeɾant ke es esensial ke els dɾets wmans siɣuin pɾotexits peɾ un rexiɱ de dɾet peɾ tal ke les peɾsones no es bexin foɾkaðes koɱ a ultiɱ rekuɾs a la reβeʎio kontɾa la tiɾania i lopɾesio
human_rights_un_cat_nv_64kb_0008	konsiðeɾant tambˈe ke es esensial de pɾomouɾe el desenbolupament de relasions amistoses entɾe les nasions
human_rights_un_cat_nv_64kb_0009	konsiðeɾant ke els poβles de les nasions uniðes an ratifikat en la kaɾta ʎuɾ fe en els dɾets wmans fonamentals en la dignitat i el baloɾ de la peɾsona wmana i en la iɣualtat de dɾet domes i dones
human_rights_un_cat_nv_64kb_0010	i ke an desiðit de pɾomouɾe el pɾogɾes sosial i miʎoɾaɾ el niβeʎ de biða dins duna ʎiβeɾtat mes amplia
human_rights_un_cat_nv_64kb_0011	konsiðeɾant ke els estats membɾes ʃan kompɾomes a aseguɾaɾ en kopeɾasjˈo amb loɾganitsasjˈo de les nasions uniðes el respekte uniβeɾsal i efektiu dels dɾets wmans i les ʎiβeɾtats fonamentals
human_rights_un_cat_nv_64kb_0012	konsiðeɾant ke una konsepsjˈo komuna dakests dɾets i ʎiβeɾtats es de la mes gɾan impoɾtansia peɾ al ple kompliment dakest kompɾomis
human_rights_un_cat_nv_64kb_0013	lasemblea xeneɾal
human_rights_un_cat_nv_64kb_0014	pɾoklama akesta deklaɾasjˈo uniβeɾsal de dɾets wmans koɱ liðeal komu a asoliɾ peɾ a tots els poβles i nasions amb el fi ke kaða peɾsona i kaða institusio inspiɾantse konstantment en akesta deklaɾasio pɾomoguin mitxankant lensenjament i leðukasio el respekte a akests dɾets i ʎiβeɾtats i aseguɾin amb mesuɾes pɾogɾesiβes nasionals i inteɾnasionals el seu rekoneiksement i aplikasjˈo uniβeɾsals i efektius tant entɾe els poβles dels estats membɾes koɱ entɾe els dels teritoɾis sota ʎuɾ xuɾizðiksios
human_rights_un_cat_nv_64kb_0015	aɾtikle
human_rights_un_cat_nv_64kb_0016	tots els eseɾs wmans neiksen ʎiuɾes i iɣuals en dignitat i en dɾets
human_rights_un_cat_nv_64kb_0017	son dotats de rao i de konsiensia i an de kompoɾtaɾse fɾateɾnalment els uns amb els altɾes
human_rights_un_cat_nv_64kb_0018	aɾtikle s
human_rights_un_cat_nv_64kb_0019	totoɱ te tots els dɾets i ʎiβeɾtats pɾoklamats en akesta deklaɾasio sense kap distinsjˈo de raka koloɾ sekse ʎengua relixio opinio politika o de kalseβol altɾa mena oɾixen nasional o sosial foɾtuna naiksement o altɾa kondisios
human_rights_un_cat_nv_64kb_0020	a mes no es faɾa kap distinsjˈo basaða en lestatut politik xuɾiðik o inteɾnasional del pais o del teritoɾi al kal peɾtanji una peɾsona tant si es independent koɱ si esta sota aðministɾasjˈo fiðusiaɾia si no es autonom o esta sota kalseβol altɾa limitasjˈo de soβiɾania
human_rights_un_cat_nv_64kb_0021	aɾtikle
human_rights_un_cat_nv_64kb_0022	tota peɾsona te dɾet a la biða a la ʎiβeɾtat i a la seβa seguɾetat
human_rights_un_cat_nv_64kb_0023	aɾtikle
human_rights_un_cat_nv_64kb_0024	ningu no seɾa sotmes a esklaβituð o seɾβituð lesklaβituð i el tɾafik desklaus son pɾojβits en totes ʎuɾs foɾmes
human_rights_un_cat_nv_64kb_0025	aɾtikle
human_rights_un_cat_nv_64kb_0026	ningu no seɾa sotmes a toɾtuɾes ni a penes o tɾaktes kɾuels inwmans o degɾaðants
human_rights_un_cat_nv_64kb_0027	aɾtikle
human_rights_un_cat_nv_64kb_0028	tota peɾsona te el dɾet areu al rekoneiksement de la seβa peɾsonalitat xuɾiðika
human_rights_un_cat_nv_64kb_0029	aɾtikle sk
human_rights_un_cat_nv_64kb_0030	tots son iɣuals daβant la ʎei i tenen dɾet sense kap distinsio a iɣual pɾoteksjˈo peɾ la ʎeis
human_rights_un_cat_nv_64kb_0031	tots tenen dɾet a iɣual pɾoteksjˈo kontɾa kalseβol diskɾiminasjˈo ke bioli akesta deklaɾasjˈo i kontɾa kalseβol insitasjˈo a una tal diskɾiminasios
human_rights_un_cat_nv_64kb_0032	aɾtikle
human_rights_un_cat_nv_64kb_0033	tota peɾsona te dɾet a un rekuɾs efektiu pɾop dels tɾiβunals nasionals kompetents ke lempaɾi kontɾa aktes ke biolin els seus dɾets fonamentals rekoneguts peɾ la konstitusjˈo o peɾ la ʎeis
human_rights_un_cat_nv_64kb_0034	aɾtikle
human_rights_un_cat_nv_64kb_0035	ningu no seɾa detingut pɾes o desterat aɾβitɾaɾiament
human_rights_un_cat_nv_64kb_0036	aɾtikle a
human_rights_un_cat_nv_64kb_0037	tota peɾsona te dɾet en kondisions de plena iɣualtat a seɾ eskoltaða puβlikament i amb xustisia peɾ un tɾiβunal independent i impaɾsial peɾ a la deteɾminasjˈo dels seus dɾets i oβligasions o peɾ a leksamen de kalseβol akusasjˈo kontɾa eʎa en mateɾia penal
human_rights_un_cat_nv_64kb_0038	aɾtikle
human_rights_un_cat_nv_64kb_0039	tots els akusats dun delikte tenen el dɾet ke oɱ pɾesumeiksi la seβa inosensia fins ke no es pɾoβi la seβa kulpaβilitat segons la ʎei en un xuðisi puβlik en ke oɱ li axi aseguɾat totes les gaɾanties nesesaɾies peɾ a la seβa defensa
human_rights_un_cat_nv_64kb_0040	ningu no seɾa kondemnat peɾ aktes o omisions ke en el moment ke baɾen eseɾ komesos no eɾen deliktius segons el dɾet nasional o inteɾnasional
human_rights_un_cat_nv_64kb_0041	tampok no simposaɾa kap pena supeɾioɾ a laplikaβle en el moment de kometɾe el delikte
human_rights_un_cat_nv_64kb_0042	aɾtikle s
human_rights_un_cat_nv_64kb_0043	ningu no seɾa oβxekte dintɾomisions aɾβitɾaɾies en la seβa biða pɾiβaða la seβa familia el seu domisili o la seβa korespondensia ni dataks al seu onoɾ i reputasios
human_rights_un_cat_nv_64kb_0044	totoɱ te dɾet a la pɾoteksjˈo de la ʎei kontɾa tals intɾomisions o ataks
human_rights_un_cat_nv_64kb_0045	aɾtikle
human_rights_un_cat_nv_64kb_0046	tota peɾsona te dɾet a siɾkulaɾ ʎiuɾement i a tɾiaɾ la seβa resiðensia dins les fɾonteɾes de kaða estat
human_rights_un_cat_nv_64kb_0047	tota peɾsona te dɾet o soɾtiɾ de kalseβol pas aðuk el pɾopi i a retoɾnaɾjs
human_rights_un_cat_nv_64kb_0048	aɾtikle
human_rights_un_cat_nv_64kb_0049	en kas de peɾsekusio tota peɾsona te dɾet a seɾkaɾ asil en altɾes paisos i a benefisiaɾsen
human_rights_un_cat_nv_64kb_0050	akest dɾet no poðɾa seɾ inbokat kontɾa una peɾsekusjˈo beɾitaβlement oɾixinaða peɾ deliktes komuns o peɾ aktes oposats als oβxektius i pɾinsipis de les nasions uniðes
human_rights_un_cat_nv_64kb_0051	aɾtikle
human_rights_un_cat_nv_64kb_0052	tota peɾsona te dɾet a una nasionalitat
human_rights_un_cat_nv_64kb_0053	ningu no seɾa pɾiβat aɾβitɾaɾiament de la seβa nasionalitat ni del dɾet de kanbiaɾ de nasionalitat
human_rights_un_cat_nv_64kb_0054	aɾtikle r
human_rights_un_cat_nv_64kb_0055	els omes i les dones a paɾtiɾ de leðat nuβil tenen dɾet sense kap restɾiksjˈo peɾ motius de raka nasionalitat o relixio a kasaɾse i a fundaɾ una familia
human_rights_un_cat_nv_64kb_0056	gauðiɾan de dɾets iɣuals pel ke fa al kasament duɾant el matɾimoni i en la seβa disolusios
human_rights_un_cat_nv_64kb_0057	nomes es realitsaɾa el kasament amb el ʎiuɾe i ple konsentiment dels futuɾs esposos
human_rights_un_cat_nv_64kb_0058	la familia es lelement natuɾal i fonamental de la sosietat i te dɾet a la pɾoteksjˈo de la sosietat i de lestat
human_rights_un_cat_nv_64kb_0059	aɾtikle sk
human_rights_un_cat_nv_64kb_0060	tota peɾsona te dɾet a la pɾopietat indiβiðualment i koʎektiβa
human_rights_un_cat_nv_64kb_0061	ningu no seɾa pɾiβat aɾβitɾaɾiament de la seβa pɾopietat
human_rights_un_cat_nv_64kb_0062	aɾtikle k
human_rights_un_cat_nv_64kb_0063	tota peɾsona te dɾet a la ʎiβeɾtat de pensament de konsiensia i de relixio
human_rights_un_cat_nv_64kb_0064	akest dɾet inklou la ʎiβeɾtat de kanbiaɾ de relihjˈo o de kɾenka i la ʎiβeɾtat indiβiðualment o koʎektiβament en puβlik o en pɾiβat de manifestaɾ la seβa relihjˈo o kɾenka peɾ mitxa de lensenjament la pɾaktika el kulte i loβseɾβanka
human_rights_un_cat_nv_64kb_0065	aɾtikle
human_rights_un_cat_nv_64kb_0066	tota peɾsona te dɾet a la ʎiβeɾtat dopinio i dekspɾesio
human_rights_un_cat_nv_64kb_0067	akest dɾet inklou el de no seɾ molestat a kausa de les pɾopies opinions i el de seɾkaɾ reβɾe i difondɾe les infoɾmasions i les iðes peɾ kalseβol mitxa i sense limit de fɾonteɾes
human_rights_un_cat_nv_64kb_0068	aɾtikle e
human_rights_un_cat_nv_64kb_0069	tota peɾsona te dɾet a la ʎiβeɾtat de reunio i dasosiasjˈo pasifikes
human_rights_un_cat_nv_64kb_0070	ningu no pot seɾ oβligat a peɾtanjeɾ a una asosiasios
human_rights_un_cat_nv_64kb_0071	aɾtikle e
human_rights_un_cat_nv_64kb_0072	tota peɾsona te dɾet a paɾtisipaɾ en el goβeɾn del seu pas diɾektament o peɾ mitxa de repɾesentants ʎiuɾement elexits
human_rights_un_cat_nv_64kb_0073	tota peɾsona te dɾet en kondisions diɣualtat a akseðiɾ a les funsions puβlikes del seu pais
human_rights_un_cat_nv_64kb_0074	la boluntat del poβle es el fonament de lautoɾitat de lestat
human_rights_un_cat_nv_64kb_0075	akesta boluntat a dekspɾesaɾse mitxankant eleksions autentikes ke auɾan de feɾse peɾioðikament peɾ sufɾaxi uniβeɾsal i iɣual i peɾ bot sekɾet o peɾ altɾe pɾoseðiment ekiβalent ke gaɾanteiksi la ʎiβeɾtat del bot
human_rights_un_cat_nv_64kb_0076	aɾtikle es
human_rights_un_cat_nv_64kb_0077	tota peɾsona koɱ a membɾe de la sosietat te dɾet a la seguɾetat sosial i a oβteniɾ mitxankant lesfoɾs nasional i la kopeɾasjˈo inteɾnasional segons loɾganitsasjˈo i els rekuɾsos de kaða pas la satisfaksjˈo dels dɾets ekonomiks sosials i kultuɾals indispensaβles peɾ a la seβa dignitat i el ʎiuɾe desenbolupament de la seβa peɾsonalitat
human_rights_un_cat_nv_64kb_0078	aɾtikle e
human_rights_un_cat_nv_64kb_0079	tota peɾsona te dɾet al tɾeβaʎ a la ʎiuɾe eleksjˈo de la seβa okupasio a kondisions ekitatiβes i satisfaktoɾies de tɾeβaʎ i a la pɾoteksjˈo kontɾa latuɾ
human_rights_un_cat_nv_64kb_0080	tota peɾsona sense kap diskɾiminasio te dɾet a salaɾi iɣual peɾ iɣual tɾeβall
human_rights_un_cat_nv_64kb_0081	totoɱ ke tɾeβaʎa te dɾet a una remuneɾasjˈo ekitatiβa i satisfaktoɾia ke aseguɾi peɾ a eʎ i la seβa familia una eksistensia konfoɾme a la dignitat wmana kompletaða si kal amb altɾes mitxans de pɾoteksjˈo sosial
human_rights_un_cat_nv_64kb_0082	totoɱ te dɾet a konstituiɾ sindikats peɾ a la defensa dels seus inteɾesos i a afiliaɾʃjs
human_rights_un_cat_nv_64kb_0083	aɾtikle e
human_rights_un_cat_nv_64kb_0084	tota peɾsona te dɾet al deskans i al ʎeuɾe i paɾtikulaɾment a una limitasjˈo raonaβle de la xoɾnaða de tɾeβaʎ i a bakanses peɾioðikes pagaðes
human_rights_un_cat_nv_64kb_0085	aɾtikle e
human_rights_un_cat_nv_64kb_0086	tota peɾsona te dɾet a un niβeʎ de biða ke aseguɾi peɾ a eʎ i la seβa familia la salut i el benestaɾ espesialment kant a alimentasio bestiɾ aβitatxe asistensia meðika i als seɾβeis sosials nesesaɾis
human_rights_un_cat_nv_64kb_0087	tambˈe te dɾet a la seguɾetat en kas datuɾ malaltia inkapasitat biðuitat beʎesa o altɾa manka de mitxans de suβsistensia independent de la seβa boluntat
human_rights_un_cat_nv_64kb_0088	la mateɾnitat i la infantesa tenen dɾet a una kuɾa i a una asistensia espesials
human_rights_un_cat_nv_64kb_0089	tots els infants naskuts dun matɾimoni o foɾa dun matɾimoni gauðeiksen diɣual pɾoteksjˈo sosial
human_rights_un_cat_nv_64kb_0090	aɾtikle e
human_rights_un_cat_nv_64kb_0091	tota peɾsona te dɾet a leðukasios
human_rights_un_cat_nv_64kb_0092	leðukasjˈo seɾa gɾatuita si mes no en la instɾuksjˈo elemental i fonamental
human_rights_un_cat_nv_64kb_0093	la instɾuksjˈo elemental seɾa oβligatoɾia
human_rights_un_cat_nv_64kb_0094	lensenjament teknik i pɾofesional es posaɾa a laβast de totom i lakses a lensenjament supeɾioɾ seɾa iɣual peɾ a tots en funsjˈo dels meɾits respektius
human_rights_un_cat_nv_64kb_0095	leðukasjˈo tendiɾa al ple desenbolupament de la peɾsonalitat wmana i a lenfoɾtiment del respekte als dɾets wmans i a les ʎiβeɾtats fonamentals
human_rights_un_cat_nv_64kb_0096	pɾomouɾa la kompɾensio la toleɾansia i lamistat entɾe totes les nasions i gɾups etniks o relixiosos i fomentaɾa les aktiβitats de les nasions uniðes peɾ al manteniment de la paus
human_rights_un_cat_nv_64kb_0097	el paɾe i la maɾe tenen dɾet pɾefeɾent deskoʎiɾ la mena deðukasjˈo ke seɾa donaða als seus fiʎs
human_rights_un_cat_nv_64kb_0098	aɾtikle esk
human_rights_un_cat_nv_64kb_0099	tota peɾsona te dɾet a paɾtisipaɾ ʎiuɾement en la biða kultuɾal de la komunitat a gauðiɾ de les aɾts i a paɾtisipaɾ i benefisiaɾse del pɾogɾes sientifik
human_rights_un_cat_nv_64kb_0100	tota peɾsona te dɾet a la pɾoteksjˈo dels inteɾesos moɾals i mateɾials deɾiβats de les pɾoðuksions sientifikes liteɾaɾies o aɾtistikes de ke siɣui autoɾ
human_rights_un_cat_nv_64kb_0101	aɾtikle e
human_rights_un_cat_nv_64kb_0102	tota peɾsona te dɾet a un oɾðɾe sosial i inteɾnasional en ke els dɾets i ʎiβeɾtats pɾoklamats en akesta deklaɾasjˈo puguin seɾ plenament efektius
human_rights_un_cat_nv_64kb_0103	aɾtikle e
human_rights_un_cat_nv_64kb_0104	tota peɾsona te deuɾes enbeɾs la komunitat xa ke nomes en akesta li es posiβle el ʎiuɾe i ple desenbolupament de la seβa peɾsonalitat
human_rights_un_cat_nv_64kb_0105	en lekseɾsisi dels dɾets i les ʎiβeɾtats totoɱ estaɾa sotmes nomes a les limitasions estaβleɾtes peɾ la ʎei i unikament amb la finalitat daseguɾaɾ el rekoneiksement i el respekte deguts als dɾets i ʎiβeɾtats dels altɾes i de kompliɾ les xustes eksixensies de la moɾal de loɾðɾe puβlik i del benestaɾ xeneɾal en una sosietat demokɾatika
human_rights_un_cat_nv_64kb_0106	akests dɾets i ʎiβeɾtats mai no poðɾan seɾ ekseɾsits en oposisjˈo als oβxektius i pɾinsipis de les nasions uniðes
human_rights_un_cat_nv_64kb_0107	aɾtikle
human_rights_un_cat_nv_64kb_0108	res en akesta deklaɾasjˈo no poðɾa inteɾpɾetaɾse en el sentit ke doni kap dɾet a un estat a un gɾup o a una peɾsona a empɾendɾe aktiβitats o a realitsaɾ aktes ke tendeiksin a la supɾesio de kalseβol dels dɾets i ʎiβeɾtats ke ʃj enunsien
