human_rights_un_oc_am_64kb_0001	Declaracioun universalo di dre de l'ome
human_rights_un_oc_am_64kb_0002	Article 1
human_rights_un_oc_am_64kb_0003	Tóuti lis uman naisson libre.
human_rights_un_oc_am_64kb_0004	Soun egau pèrla digneta e li dre.
human_rights_un_oc_am_64kb_0005	An tóuti uno resoun e uno counsciènci.
human_rights_un_oc_am_64kb_0006	Se dèvon tenifreirenau lis un 'mé lis autre.
human_rights_un_oc_am_64kb_0007	Article 2
human_rights_un_oc_am_64kb_0008	Tout èsse uman a tóuti li liberta e tóuti lidre prouclama dins aquesto declaracioun, sènso ges li destria pèr de raço, decoulour, de sèisse, de lengo, de religioun, d'idèio poulitico o d'autro meno,d'óurigino naciounalo o soucialo, de richesso, de neissènço o d'àutricoundicioun.
human_rights_un_oc_am_64kb_0009	En mai, se fara ges de destriamen foundasubre l'estatut pouliti, amenistratiéu o internaciounau dóu païs o de l'endréde la persouno, fugue aquel endré independènt o sa soubeiraneta countourrouladoo limitado d'un biais o d'un autre.
human_rights_un_oc_am_64kb_0010	Article 3
human_rights_un_oc_am_64kb_0011	Cado persouno a dre à la vido, à la liberta,e à la segureta.
human_rights_un_oc_am_64kb_0012	Article 4
human_rights_un_oc_am_64kb_0013	Degun sara soumés à l'esclavitudo o à laservitudo.
human_rights_un_oc_am_64kb_0014	Es enebi en plen de teni d'esclau o de n'en faire coumèrci.
human_rights_un_oc_am_64kb_0015	Article 5
human_rights_un_oc_am_64kb_0016	Degun sara soumés à la tourturo nimai à depeno o de tratamen crudèu, inuman o desgradant.
human_rights_un_oc_am_64kb_0017	Article 6
human_rights_un_oc_am_64kb_0018	Cadun a dre à la recouneissènço de sapersounalita juridico de pertout.
human_rights_un_oc_am_64kb_0019	Article 7
human_rights_un_oc_am_64kb_0020	Tóuti li gènt soun egau davans la lèi.
human_rights_un_oc_am_64kb_0021	Memamen an tóuti dre d'èstre apara pèr la lèi sènso ges de destriamen.
human_rights_un_oc_am_64kb_0022	An tóutidre d'èstre apara parié contro tout ço que vióularié aquesto declaracioun o quebutarié à la vióula.
human_rights_un_oc_am_64kb_0023	Article 8
human_rights_un_oc_am_64kb_0024	Touto persouno a lou dre de s'apela proche litribunau naciounau coumpetènt.
human_rights_un_oc_am_64kb_0025	Aquéli ié dèvon l'eficàci e la dèvon defèndrecontro lis ate que violon li dre foundamentau recouneigu pèr la lèi e lacoustitucioun.
human_rights_un_oc_am_64kb_0026	Article 9
human_rights_un_oc_am_64kb_0027	Degun sara arresta, embarra vo eisila pèrarbitràri.
human_rights_un_oc_am_64kb_0028	Article 10
human_rights_un_oc_am_64kb_0029	Tóuti li persouno an lou meme dre de pleidejapublicamen sa defènso davans un tribunau que lis escoutara em'un esperitd'independènci e de justiço, que se prounounciara pièi siegue toucant si dre esis óubligacioun, siegue toucant la foundamento de touto acusacioun contro eloen matèri penalo.
human_rights_un_oc_am_64kb_0030	Article 11
human_rights_un_oc_am_64kb_0031	Touto persouno acusado d'un ate fautible es regardado coume innoucènto jusco que fugue legalamen establido sa coupableta pèr un proucès publi.
human_rights_un_oc_am_64kb_0032	Dins aquéu proucès, tóuti li garantido necito à sa defènso ié saran estado pourgido.
human_rights_un_oc_am_64kb_0033	Res sara coundana pèr d'ate o d'óublit qu'èron pas counsidera fautible segound lou dre naciounau o internaciounau quouro fuguèron fa.
human_rights_un_oc_am_64kb_0034	Mai qu'acò, se pòu pas coundana li gènt en de peno mai forto d'aquéli que se poudien aplica quouro l'ate fautible fuguè coumés.
human_rights_un_oc_am_64kb_0035	Article 12
human_rights_un_oc_am_64kb_0036	Se pòu pas sènso resoun valablo bouta lou nasdins la vido privado, la famiho, l'oustau o lou courrié di gènt.
human_rights_un_oc_am_64kb_0037	Se pòu nimaiataca soun ounour e sa reputacioun.
human_rights_un_oc_am_64kb_0038	Touto persouno a lou dre d'èstre aparadopèr la lèi contro aquéli malafacho.
human_rights_un_oc_am_64kb_0039	Article 13
human_rights_un_oc_am_64kb_0040	Cadun a lou dre d'ana d'ounte vòu, de planta caviho d'ounte vòu dedins li raro d'un Estat.
human_rights_un_oc_am_64kb_0041	Cadun a lou dre de quita un païs e lou siéu tambèn.
human_rights_un_oc_am_64kb_0042	Cadun a lou dre de s'entourna au païs siéu.
human_rights_un_oc_am_64kb_0043	Article 14
human_rights_un_oc_am_64kb_0044	Quouro secutado, touto persouno a lou dre de cerca un recate dins d'àutri païs e de lou prouficha.
human_rights_un_oc_am_64kb_0045	Pòu pas s'apela d'aqueste dre uno persouno perseguido de-bon pèr un crime de dre coumun o d'ate countràri i principe emai i toco di Nacioun Unido.
human_rights_un_oc_am_64kb_0046	Article 15
human_rights_un_oc_am_64kb_0047	Cadun a dre à uno naciounalita.
human_rights_un_oc_am_64kb_0048	Se pòu leva en res pèr arbitràri sa naciounalita o lou dre de la chanja.
human_rights_un_oc_am_64kb_0049	Article 16
human_rights_un_oc_am_64kb_0050	L'ome e la femo, s'un cop soun maridadou, an lou dre de se marida e de founda uno famiho, sènso ges d'empache pèr encauso de raço, de naciounalita o de religioun.
human_rights_un_oc_am_64kb_0051	Li dre dis ome e di femo soun parié raport au maridage, que siegue dóu tèms que soun marida o quouro se divorçon.
human_rights_un_oc_am_64kb_0052	Lou maridage se pòu faire soulamen se li nòvi se volon de-bon.
human_rights_un_oc_am_64kb_0053	La famiho es la foundamento naturalo de la soucieta.
human_rights_un_oc_am_64kb_0054	A dre d'èstre aparado pèr la soucieta e l'Estat.
human_rights_un_oc_am_64kb_0055	Article 17
human_rights_un_oc_am_64kb_0056	Touto persouno, souleto o coutrìo 'mé d'àutri gènt, a dre à la prouprieta.
human_rights_un_oc_am_64kb_0057	Degun sara despoussedi de soun bèn pèr arbitràri.
human_rights_un_oc_am_64kb_0058	Article 18
human_rights_un_oc_am_64kb_0059	Touto persouno es libro de sa pensado, de sacounsciènci e de sa religioun.
human_rights_un_oc_am_64kb_0060	En aquéu dre ié caup la liberta de cambia dereligioun o de crèire, e tambèn de manifesta sa religioun o si crèire, soulet o'mé d'àutri gènt, dins la vido publico o privado, pèr l'ensignamen, lis usage,lou culte emai l'acoumplissamen di rite.
human_rights_un_oc_am_64kb_0061	Article 19
human_rights_un_oc_am_64kb_0062	Tout persouno a dre à la liberta d'óupinioune d'espressioun.
human_rights_un_oc_am_64kb_0063	En aquéu dre ié caup de rèn se capita carcagna pèr encauso deço que pensas, e tambèn de cerca, reçaupre e espandi lis enfourmacioun e lisidèio, coume que siegue lou mejan d'espressioun, sènso empache à respèt difrountiero.
human_rights_un_oc_am_64kb_0064	Article 20
human_rights_un_oc_am_64kb_0065	Tóuti li gènt an lou dre de s'acampa e de s'assoucia dins un esperit de pas.
human_rights_un_oc_am_64kb_0066	Degun pòu èstre óublija de faire partido d'un groupamen.
human_rights_un_oc_am_64kb_0067	Article 21
human_rights_un_oc_am_64kb_0068	Touto persouno a lou dre de partecipa au gouvernamen de soun païs, siegue direitamen siegue depèr de representant chausi libramen.
human_rights_un_oc_am_64kb_0069	Touto persouno a lou dre d'óuteni de founcioun publico de soun païs dins de coundicioun d'egalita.
human_rights_un_oc_am_64kb_0070	La voulounta dóu pople es la foundamento de l'autourita di poudé publi.
human_rights_un_oc_am_64kb_0071	Aquesto voulounta se dèu espremi depèr d'eleicioun ounèsto que saran estigançado à cadènço reglado, au sufrage universau emé buletin secret, o d'un biais equivalènt que posque assegura la liberta dóu vote.
human_rights_un_oc_am_64kb_0072	Article 22
human_rights_un_oc_am_64kb_0073	Touto persouno, en fasènt partido de lasoucieta, a dre d'uno prouteicioun soucialo e de coumpli si dre ecounoumi,souciau e culturau;
human_rights_un_oc_am_64kb_0074	e acò bonadi lis esperfors naciounau e l'entre-ajudointernaciounalo, segound l'ourganisacioun e li mejan de chasque païs, que ladigneta e lou desvouloupa libre de la persounalita podon pas faire sènso.
human_rights_un_oc_am_64kb_0075	Article 23
human_rights_un_oc_am_64kb_0076	Cadun a lou dre de travaia, de chausi libre soun mestié, dins de coundicioun equitablo d'obro e de prouteicioun contro lou chaumage.
human_rights_un_oc_am_64kb_0077	Tóuti an dre en uno memo pago pèr uno memo obro, sènso ges de destriamen.
human_rights_un_oc_am_64kb_0078	Un que travaio a dre en uno pago justo e counvenènto, que sara coumpletado se ié fai besoun pèr tóuti lis àutri mejan de prouteicioun soucialo.
human_rights_un_oc_am_64kb_0079	Dins tout acò, dèu pousqué viéure de-segur dignamen emé sa famiho.
human_rights_un_oc_am_64kb_0080	Touto persouno a lou dre de founda emé d'autro de sendicat e d'èstre sòci d'un sendicat pèr defèndre sis interès.
human_rights_un_oc_am_64kb_0081	Article 24
human_rights_un_oc_am_64kb_0082	Cadun a dre de se pausa e de s'espaça.
human_rights_un_oc_am_64kb_0083	A dreà uno tanco resounablo de la journado de travai, à de counget regulié e paga.
human_rights_un_oc_am_64kb_0084	Article 25
human_rights_un_oc_am_64kb_0085	Tóuti an dre à un nivèu de vido que i'assegure la santa e lou bèn-èstre emai à sa famiho, mai que mai pèr lou manja, lou vèsti, l'oustau, li siuen de santa e pèr tóuti li service souciau necite.
human_rights_un_oc_am_64kb_0086	Pèr escasènço que un posque pas mai se gagna sa vido sènso l'avé vougu, pèr eisèmple se vèn vièi, malaut, endeca o chaumaire, a dre à la segureta.
human_rights_un_oc_am_64kb_0087	Li femo embarrassado, li maire e li pichot an dre à uno ajudo particuliero.
human_rights_un_oc_am_64kb_0088	Siegon pas si gènt marida, e lou fuguèsson pas quouro lou nistoun es nascu, tóuti li pichot proufichon pamens la memo prouteicioun soucialo.
human_rights_un_oc_am_64kb_0089	Article 26
human_rights_un_oc_am_64kb_0090	Touto persouno a lou dre d'èstre educado.
human_rights_un_oc_am_64kb_0091	L'educacioun dèu èstre à-gràtis, lou plus pau pèr ço que pretoco l'ensignamen elementàri e foundamentau.
human_rights_un_oc_am_64kb_0092	L'ensignamen elementàri es óubligatòri.
human_rights_un_oc_am_64kb_0093	L'ensignamen di teinico e di mestié dèu èstre d'atencho pèr tóuti.
human_rights_un_oc_am_64kb_0094	Lis estùdi superiour dèvon èstre dubert à tóuti parié à respèt de si merite.
human_rights_un_oc_am_64kb_0095	La toco de l'educacioun es que la persounalita di gènt s'espeligue, e que lou respèt degu i dre de l'ome e i liberta foundamentalo s'afourtigue.
human_rights_un_oc_am_64kb_0096	Dèu favourisa la coumprenènço, la touleranço e l'amista entre tóuti li nacioun, li group etni vo religious, emai lou crèis dis ativeta di Nacioun-Unido.
human_rights_un_oc_am_64kb_0097	pèr manteni la pas.
human_rights_un_oc_am_64kb_0098	Lou paire emai la maire an lou dre de chausi, bèu proumié, lou biais d'educacioun que volon pèr si pichot.
human_rights_un_oc_am_64kb_0099	Article 27
human_rights_un_oc_am_64kb_0100	Touto persouno a lou dre de partecipa libramen à la vido culturalo de la coumunauta, au prougrès scientifi e i bèn-fa qu'aduson.
human_rights_un_oc_am_64kb_0101	Tout lou mounde a lou dre de prouficha lou plesi coungreia pèr lis art.
human_rights_un_oc_am_64kb_0102	L'autour d'uno obro scientifico, literàri o artistico a dre à l'aparamen de sis interès mourau e financié.
human_rights_un_oc_am_64kb_0103	Article 28
human_rights_un_oc_am_64kb_0104	Touto persouno a lou dre de viéure dins unmitan souciau e internaciounau proun ourdouna, que li dre esplica dins aquestodeclaracioun d'aqui se ié poscon aplica en plen.
human_rights_un_oc_am_64kb_0105	Article 29
human_rights_un_oc_am_64kb_0106	Touto persouno a de devé à respèt de la coumunauta, qu'es en soun dintre soulet que lou desvouloupamen libre e coumplet de sa persounalita i'es poussible.
human_rights_un_oc_am_64kb_0107	Se pòu restanca li dre e li liberta de chascun soulamen dóu biais que la lèi l'a vougu pèr fin d'assegura la recouneissènço dis autre, lou respèt de si dre e liberta;
human_rights_un_oc_am_64kb_0108	e tambèn pèr fin de respeta lis eisigènci justo de la mouralo, de la tranquileta di gènt, e dóu bèn-èstre generau dins uno soucieta demoucratico.
human_rights_un_oc_am_64kb_0109	Aquésti dre e liberta poudran jamai e de ges de biais èstre emplega pèr faire de causo countràri i principe di Nacioun-Unido.
human_rights_un_oc_am_64kb_0110	Article 30
human_rights_un_oc_am_64kb_0111	Res, ni Estat ni groupamen nimai unopersouno, poudra assaja de tira d'aquesto declaracioun lou dre de fairequaucarèn pèr escracha li dre e li liberta que ié soun esplica.
