human_rights_un_lat_vu_64kb_0001	UNIVERSALIS DE JURE HOMINUM DECLARATIOquae, decreto CCXVII A (III), a Communi Conventu probata et edicta est, Anno Domini MCMIIL, a.
human_rights_un_lat_vu_64kb_0002	d.
human_rights_un_lat_vu_64kb_0003	IV Idus Decembres.
human_rights_un_lat_vu_64kb_0004	Praefatio
human_rights_un_lat_vu_64kb_0005	Cum dignitatis infixae omnibus humanae familiae partibus et eorum jurum aequalium, quae abalienari non possunt, agnitio constituat et in orbe terrarum libertatis et justitiae et pacis fundamentum,
human_rights_un_lat_vu_64kb_0006	Cum hominis jurum mala cognitio contemptioque barbariae facta, quae humanitatis conscientiam ad rebellionem incitant, adduxerint, cumque mundi initium in quo homines, liberati a terrore et miseria, loquendi credendique libertatem habebunt, renuntiatum sit ut hominis altissima affectatio,
human_rights_un_lat_vu_64kb_0007	Cum praecipuum sit hominum jura civitatis forma quae justa est tegi, ne homo cogatur, ultimo perfugio, ut rebellionem faciat in tyranniam oppressionemque,
human_rights_un_lat_vu_64kb_0008	Cum praecipuum sit progressionem amicitiarum inter nationes incitari,
human_rights_un_lat_vu_64kb_0009	Cum in Carta gentes Conjunctarum Nationum rursus pronuntiaverint suam fidem in juribus praecipuis hominum, in dignitate et virtute hominis, in aequabilitate jurum virorum et feminarum, et se dixerint prompti ad favendum progressui civili et ad gignendum meliores conditiones vitae in majore libertate,
human_rights_un_lat_vu_64kb_0010	Cum sociae civitates pollicitae sint se affirmaturas esse verecundiam universam veramque jurum hominis et libertatum praecipuarum, temperatione Nationum Conjunctarum adjuvante,
human_rights_un_lat_vu_64kb_0011	Cum quaedam communis conceptio horum jurum et libertatum gravissima sit, ut obligatio haec plane expleatur,
human_rights_un_lat_vu_64kb_0012	Communis Conventus jurum hominis praesentem universalem Declarationem pronuntiat ut communis perfectus qui petatur ab omnibus populis et omnibus nationibus, ut societatis singuli homines et omnes partes, habentes hanc declarationem constanter in mente, institutione et educatione conantur ut horum jurum libertatumque respectus evolvatur, et firmentur ordinis nationalis et internationalis consiliorum incessu gratia et universalis veraque admotio tam in ipsarum sociarum civitatum populationibus quam in finium populationibus quae eorum jurisdictioni subactae sunt.
human_rights_un_lat_vu_64kb_0013	Universalis de hominis juribus declaratio
human_rights_un_lat_vu_64kb_0014	I
human_rights_un_lat_vu_64kb_0015	Omnes homines liberi aequique dignitate atque juribus nascuntur.
human_rights_un_lat_vu_64kb_0016	Ratione conscientiaque praediti sunt et alii erga alios cum fraternitate se gerere debent.
human_rights_un_lat_vu_64kb_0017	II
human_rights_un_lat_vu_64kb_0018	Quisque potest sibi assumere libertates omnes omnesque jures in hac declaratione pronuntiatos, sine ulla distinctione gentis, coloris, sexus, linguae, religionis, politicae sententiae aut omnis generis sententiae, nationis originis aut civitatis, divitiarum aut ortus aut omnis generis situs.
human_rights_un_lat_vu_64kb_0019	Praeterea fietur nulla distinctio condita in civili decreto, juridico aut internationali gentis aut finium cujus est aliquis, sive gens aut fines liberi sunt, sive sub tutella, sive non suae potestatis sive subacti termino aliquo sui imperii.
human_rights_un_lat_vu_64kb_0020	III
human_rights_un_lat_vu_64kb_0021	Quisque jus habet vivere, liber esse et in tuto vivere.
human_rights_un_lat_vu_64kb_0022	IV
human_rights_un_lat_vu_64kb_0023	Nemo servitudine tenebitur.
human_rights_un_lat_vu_64kb_0024	Omnes servitudines omnibus modis prohibentur.
human_rights_un_lat_vu_64kb_0025	V
human_rights_un_lat_vu_64kb_0026	Nullus cruciabitur neque poenis nec tractationibus, quae humanae sunt, objicietur.
human_rights_un_lat_vu_64kb_0027	VI
human_rights_un_lat_vu_64kb_0028	Quisque jus habet suam juridicam personam in omnibus locis accipi.
human_rights_un_lat_vu_64kb_0029	VII
human_rights_un_lat_vu_64kb_0030	Omnes ante legem aequi sunt et sine ulla distinctione jus habent aequum praesidium legis habere.
human_rights_un_lat_vu_64kb_0031	Omnes jus habent praesidio aequo contra omnem discrimen qui hanc Declarationem violet et contra omnem incitationem ad talem discrimen.
human_rights_un_lat_vu_64kb_0032	VIII
human_rights_un_lat_vu_64kb_0033	Omnis jus habet recurrere pro idoneo judice gentis contra facta violantia jures suffundatos quae sibi recognescuntur a constitutione aut lege.
human_rights_un_lat_vu_64kb_0034	IX
human_rights_un_lat_vu_64kb_0035	Nullus ex libidine apprehendi in vinculis esse, exsulari potest.
human_rights_un_lat_vu_64kb_0036	X
human_rights_un_lat_vu_64kb_0037	Omnes jus habent in tota aequitate suam causam recte et publice a judicibus liberis aequabilibusque audiri, qui statuunt vel de juribus obligationibusque, vel de veritate omnis criminis contra se.
human_rights_un_lat_vu_64kb_0038	XI
human_rights_un_lat_vu_64kb_0039	Quisquis accusatus delicto innocens est dum noxa sua jure statuata est publico judicio ubi obsides omnes necessariae ad se defendendum affirmatae erunt.
human_rights_un_lat_vu_64kb_0040	Nemo damnabitur propter acta vel praetermissiones quae, cum commitata sunt, non constituebant delictum ex jure suae gentis vel universarum gentium.
human_rights_un_lat_vu_64kb_0041	Item nulla gravior culpa irrogabitur quam illa quae applicari potuit cum delictum factum est.
human_rights_un_lat_vu_64kb_0042	XII
human_rights_un_lat_vu_64kb_0043	Nemo patibitur intercessiones ab arbitrio in rebus privatis, in familia, domo aut in epistularum consuetudine, nec ictus contra honorem famamque.
human_rights_un_lat_vu_64kb_0044	Omnis jus habet lege protegi contra tales intercessiones aut talia vulnera.
human_rights_un_lat_vu_64kb_0045	XIII
human_rights_un_lat_vu_64kb_0046	Quisque jus habet libenter iter facere et in civitate suam domum eligere.
human_rights_un_lat_vu_64kb_0047	Omnis jus habet ex omni et sua patria abire et in suam patriam redire.
human_rights_un_lat_vu_64kb_0048	XIV
human_rights_un_lat_vu_64kb_0049	In vexatione omnis jus habet perfugium quaerere et perfugium ab aliis regionibus impetrare.
human_rights_un_lat_vu_64kb_0050	Hoc jus non invocari potest in casu actionum vere constitutarum in communis juris scelere aut in factis adversus metas principiaque Conjunctarum Nationum.
human_rights_un_lat_vu_64kb_0051	XV
human_rights_un_lat_vu_64kb_0052	Omnis jus habet nationis esse.
human_rights_un_lat_vu_64kb_0053	Nemo ex libidine a sua gente privari potest neque gentis mutandae a jure privari.
human_rights_un_lat_vu_64kb_0054	XVI
human_rights_un_lat_vu_64kb_0055	Ex matrimonio se jugendi aetate, vir mulierque jus habent, nullo genere, nulla gente aut religione id nequaquam impediente, matrimonio se jungere et familiam constituere.
human_rights_un_lat_vu_64kb_0056	Jura equalia habent pro matrimonio, per matrimonium et per divortium.
human_rights_un_lat_vu_64kb_0057	Matrimonium confici non potest sine conjugum pleno liberoque consensu.
human_rights_un_lat_vu_64kb_0058	Familia societatis naturale praecipuumque elementum est et jus habet a societate et rei publica muniri.
human_rights_un_lat_vu_64kb_0059	XVII
human_rights_un_lat_vu_64kb_0060	Omnis, vel solus vel conjucte, mancipii jus habet.
human_rights_un_lat_vu_64kb_0061	Nemo potest ab arbitrio a mancipio privatus esse.
human_rights_un_lat_vu_64kb_0062	XVIII
human_rights_un_lat_vu_64kb_0063	Omnis jus sentientae, conscientiae religionisque libertati habet.
human_rights_un_lat_vu_64kb_0064	Hoc jus religionem aut conscientiam mutandi libertatem atque libertatem religionem aut fidem solam aut communem manifestam faciendi implicat, tam publice quam private, doctrina, religionibus, sacris ritorum effectuque.
human_rights_un_lat_vu_64kb_0065	XIX
human_rights_un_lat_vu_64kb_0066	Omnis jus opinionis et verba dicendi libertati habet;
human_rights_un_lat_vu_64kb_0067	quod jus non ob opiniones suas inquietari implicat, atque jus petendi, recipiendi divulgandique sine finium considerationibus percontationes cogitationesque quacumque elocutione
human_rights_un_lat_vu_64kb_0068	XX
human_rights_un_lat_vu_64kb_0069	Omnis homo jus habet libertati pacificae consociationis conventusque
human_rights_un_lat_vu_64kb_0070	Nemo potest coagi ut consociationi intersit.
human_rights_un_lat_vu_64kb_0071	XXI
human_rights_un_lat_vu_64kb_0072	Omnis homo jus habet suae gentis rerum publicarum administrationi interesse, vel directo, vel per repraesentes libere lectos.
human_rights_un_lat_vu_64kb_0073	Omnis homo jus habet conditione aequa ad suae patriae officia publica accedere.
human_rights_un_lat_vu_64kb_0074	Populi voluntas publicorum imperiorum auctoritatis fundamentum est;
human_rights_un_lat_vu_64kb_0075	illa voluntas creatione honesta exprimi debet, quae statis diebus fieri debent, universali aequo suffragio secretaque tabella vel secundum aequalem judiciorum formulam suffragii libertatem in tuto collocantem.
human_rights_un_lat_vu_64kb_0076	XXII
human_rights_un_lat_vu_64kb_0077	Omnis homo, ut rei publicae socius, sociali securitati jus habet;
human_rights_un_lat_vu_64kb_0078	hic homo jus habet satisfactionem impetrare jurum publicorum, sociorum humanorumque quae necessaria ad suam dignitatem et progressum liberum sui est, per laborem suae patriae et operam aliarum gentium, pro temperatione et divitiis omnis gentis.
human_rights_un_lat_vu_64kb_0079	XXIII
human_rights_un_lat_vu_64kb_0080	Omnis homo, labori, liberae optioni laboris, conditionibus aequis idoneisque laboris et tutelae adversus inopiam laboris jus habet.
human_rights_un_lat_vu_64kb_0081	Universi, sine discrimine,aequo praemio aequo labore jus habent.
human_rights_un_lat_vu_64kb_0082	Quiscumque laborat, jus habet aequae remunerationi idoneaeque quae sibi familiaeque confirmat vitam consentaneam humanae dignitati et, si oportet, completae omnibus ceteribus rationibus sociae tutelae.
human_rights_un_lat_vu_64kb_0083	Omnis homo cum aliis hominibus consociationes condere et consociationibus socios sibi adjungere ad commoda defendenda jus habet.
human_rights_un_lat_vu_64kb_0084	XXIV
human_rights_un_lat_vu_64kb_0085	Omnes jus habent cum quieti et otiis tum circumscriptioni modicae temporis laboris et commeatibus statis quae pecunia soluuntur
human_rights_un_lat_vu_64kb_0086	XXV
human_rights_un_lat_vu_64kb_0087	Omnes jus habent satis altae vitae ut suam valetudinem et suae familiae et suam voluptatem confirmet, praesertim quod pertinet ad cibum, vestem, domum, medicinales curas et beneficia socialia quae necesseria sunt.
human_rights_un_lat_vu_64kb_0088	Omnes jus habent securitati in penuria laboris aut in morbo aut in infirmitate aut in viduitate aut in senectute aut in aliis casibus in quibus copia vivendi esse non potest, temporibus voluntatem non sequentibus.
human_rights_un_lat_vu_64kb_0089	Mater et infans jus habent auxilio et praesentiae propriae.
human_rights_un_lat_vu_64kb_0090	Omnes pueri, sive in matrmonio sive extra matrimonium nati sunt, eodem sociali praesidio fruuntur.
human_rights_un_lat_vu_64kb_0091	XXVI
human_rights_un_lat_vu_64kb_0092	Omnis jus habet educationi.
human_rights_un_lat_vu_64kb_0093	Educatio debet gratuita esse, quod saltem pertinet ad primas praecipuasque litteras.
human_rights_un_lat_vu_64kb_0094	Primae litterae sunt necessariae.
human_rights_un_lat_vu_64kb_0095	Doctrinae ad scientiam et ad professionem pertinentes multis exponenda est;
human_rights_un_lat_vu_64kb_0096	oportet aditum studiis superis in tota aequalitate omnibus secundum meritum patere.
human_rights_un_lat_vu_64kb_0097	Oportet educationem spectare ad totam hominum beatitudinem et ad respectus jurum hominis et libertatum primarum confirmationem.
human_rights_un_lat_vu_64kb_0098	Oportet educationem favere cogitationi, patientiae amicitiaeque inter omnes gentes, omnia generum aut religionum globos;
human_rights_un_lat_vu_64kb_0099	oportet educationem favere progressioni operarum nationum sociatarum ad pacis conservationem.
human_rights_un_lat_vu_64kb_0100	Parentes in primis jus habent eligere genus educationis quod interest dare liberis suis.
human_rights_un_lat_vu_64kb_0101	XXVII
human_rights_un_lat_vu_64kb_0102	Omnis homo jus habet libere interesse culturae societatis, et frui artibus, et interesse profectibus scientiae et beneficiis quae id sequuntur.
human_rights_un_lat_vu_64kb_0103	Omnis jus habet tutelae beneficiorum moralium et materialium generatorum omni procreatione scientiae, litterarum aut artium quorum auctor est.
human_rights_un_lat_vu_64kb_0104	XXVIII
human_rights_un_lat_vu_64kb_0105	Omnis jus habet in socialibus et externis rebus ordinem regnari, ut jura et libertates enuntiatae in hac Declaratione fieri possint.
human_rights_un_lat_vu_64kb_0106	XXIX
human_rights_un_lat_vu_64kb_0107	Cuique officia sunt erga societatem, in qua solum liberum plenumque incrementum ingenii fieri potest.
human_rights_un_lat_vu_64kb_0108	In usu jurium et fructu libertatum, quisque subjicitur solum finibus lege conditis, ut solum firmet gratiam et respectum jurium libertatumque alieni, et satisfaciat rectis expostulationibus honesti, reipublicae concordiae et universae in sociatate populari valetudinis.
human_rights_un_lat_vu_64kb_0109	Haec jura libertatesque nullo modo exerceri poterunt adversus proposita et principia Nationum Conjunctorum.
human_rights_un_lat_vu_64kb_0110	XXX
human_rights_un_lat_vu_64kb_0111	Nullum decretum hujus Declarationis interpretari potest quasi civitati, societati aut cuidam homini jus aliquid implicans se dedendi alicui facinori aut aliquid faciendi ad libertates et jura evertenda, quae hoc loco enuntiata sunt.
